Name|Developer|Genre
Terraria|Re-Logic|Action,Adventure,Indie,RPG
Counter-Strike: Global Offensive|Valve,Hidden Path Entertainment|Action,Free to Play
Garry's Mod|Facepunch Studios|Indie,Simulation
Left 4 Dead 2|Valve|Action
Wallpaper Engine|Wallpaper Engine Team|Casual,Indie,Animation & Modeling,Design & Illustration,Photo Editing,Utilities
Stardew Valley|ConcernedApe|Indie,RPG,Simulation
Euro Truck Simulator 2|SCS Software|Indie,Simulation
The Witcher¬Æ 3: Wild Hunt|CD PROJEKT RED|RPG
Phasmophobia|Kinetic Games|Action,Indie,Early Access
Team Fortress 2|Valve|Action,Free to Play
Portal 2|Valve|Action,Adventure
Don't Starve Together|Klei Entertainment|Adventure,Indie,Simulation
The Forest|Endnight Games Ltd|Action,Adventure,Indie,Simulation
Hades|Supergiant Games|Action,Indie,RPG
Valheim|Iron Gate AB|Action,Adventure,Indie,RPG,Early Access
Hollow Knight|Team Cherry|Action,Adventure,Indie
The Binding of Isaac: Rebirth|Nicalis, Inc.,Edmund McMillen|Action
Among Us|Innersloth|Casual
Dying Light|Techland|Action,RPG
Counter-Strike|Valve|Action
Bloons TD 6|Ninja Kiwi|Strategy
Portal 2|Valve|Action,Adventure
The Elder Scrolls V: Skyrim|Bethesda Game Studios|RPG
People Playground|mestiez|Action,Casual,Indie,Simulation
Risk of Rain 2|Hopoo Games|Action,Indie
Tomb Raider|Crystal Dynamics,Eidos-Montr√©al,Feral Interactive (Mac),Nixxes|Action,Adventure
RimWorld|Ludeon Studios|Indie,Simulation,Strategy
Subnautica|Unknown Worlds Entertainment|Adventure,Indie
DARK SOULS‚Ñ¢ III|FromSoftware, Inc.|Action
Undertale|tobyfox|Indie,RPG
Mount & Blade: Warband|TaleWorlds Entertainment|Action,RPG
Vampire Survivors|poncle|Action,Casual,Indie,RPG,Early Access
Doki Doki Literature Club!|Team Salvato|Casual,Free to Play,Indie
Half-Life 2|Valve|Action
Unturned|Smartly Dressed Games|Action,Adventure,Casual,Free to Play,Indie
Lethal Company|Zeekerss|Action,Adventure,Indie,Early Access
Sid Meier's Civilization¬Æ V|Firaxis Games,Aspyr (Mac),Aspyr (Linux)|Strategy
Portal|Valve|Action
Tom Clancy's Rainbow Six¬Æ Siege|Ubisoft Montreal|Action
Fallout: New Vegas|Obsidian Entertainment|Action,RPG
Borderlands 2|Gearbox Software,Aspyr (Mac),Aspyr (Linux)|Action,RPG
Slay the Spire|Mega Crit Games|Indie,Strategy
Factorio|Wube Software LTD.|Casual,Indie,Simulation,Strategy
Deep Rock Galactic|Ghost Ship Games|Action
Life is Strange - Episode 1|DONTNOD Entertainment,Feral Interactive (Mac),Feral Interactive (Linux)|Action,Adventure
Helltaker|vanripper|Adventure,Free to Play,Indie
Sekiro‚Ñ¢: Shadows Die Twice - GOTY Edition|FromSoftware|Action,Adventure
BeamNG.drive|BeamNG|Racing,Simulation,Early Access
ELDEN RING|FromSoftware Inc.|Action,RPG
Warframe|Digital Extremes|Action,Free to Play,RPG
PAYDAY 2|OVERKILL - a Starbreeze Studio.|Action,RPG
Divinity: Original Sin 2 - Definitive Edition|Larian Studios|Adventure,RPG,Strategy
Grand Theft Auto V|Rockstar North|Action,Adventure
Counter-Strike: Source|Valve|Action
DOOM|id Software|Action
Resident Evil 2|CAPCOM Co., Ltd.|Action
Sid Meier's Civilization¬Æ V|Firaxis Games,Aspyr (Mac),Aspyr (Linux)|Strategy
Dead Cells|Motion Twin|Action,Indie
Dota 2|Valve|Action,Free to Play,Strategy
Slime Rancher|Monomi Park|Action,Adventure,Indie,Simulation
Totally Accurate Battle Simulator|Landfall|Indie,Simulation,Strategy
Rocket League¬Æ|Psyonix LLC|Action,Indie,Racing,Sports
Satisfactory|Coffee Stain Studios|Adventure,Indie,Simulation,Strategy,Early Access
Human: Fall Flat|No Brakes Games|Adventure,Casual,Indie,Simulation
Rust|Facepunch Studios|Action,Adventure,Indie,Massively Multiplayer,RPG
Cuphead|Studio MDHR Entertainment Inc.|Action,Indie
Geometry Dash|RobTop Games|Action,Indie
Cities: Skylines|Colossal Order Ltd.|Simulation,Strategy
Half-Life: Alyx|Valve|Action,Adventure
American Truck Simulator|SCS Software|Indie,Simulation
Don't Starve|Klei Entertainment|Adventure,Indie,Simulation
Raft|Redbeet Interactive|Adventure,Indie,Simulation
BioShock Infinite|Irrational Games,Virtual Programming (Linux)|Action
Plants vs. Zombies GOTY Edition|PopCap Games, Inc.|Strategy
Halo: The Master Chief Collection|343 Industries,Splash Damage,Ruffian Games,Bungie,Saber Interactive|Action
Hotline Miami|Dennaton Games|Action,Indie
Mirror|KAGAMI WORKS|Adventure,Indie,RPG
Ori and the Will of the Wisps|Moon Studios GmbH|Action
Castle Crashers¬Æ|The Behemoth|Action,Adventure,Casual,Indie,RPG
It Takes Two|Hazelight|Action,Adventure
Oxygen Not Included|Klei Entertainment|Indie,Simulation
Titanfall¬Æ 2|Respawn Entertainment|Action
Outlast|Red Barrels|Action,Adventure,Indie
Inscryption|Daniel Mullins Games|Adventure,Indie,Strategy
Dishonored|Arkane Studios|Action,Adventure
Dyson Sphere Program|Youthcat Studio|Indie,Simulation,Strategy,Early Access
Age of Empires II (2013)|Skybox Labs,Hidden Path Entertainment,Ensemble Studios,Forgotten Empires|Strategy
Hearts of Iron IV|Paradox Development Studio|Simulation,Strategy
Portal|Valve|Action
Half-Life|Valve|Action
BattleBlock Theater¬Æ|The Behemoth|Action,Adventure,Casual,Indie
Kerbal Space Program|Squad|Indie,Simulation
Starbound|Chucklefish|Action,Adventure,Casual,Indie,RPG
Celeste|Extremely OK Games, Ltd.|Action,Adventure,Indie
The Elder Scrolls V: Skyrim Special Edition|Bethesda Game Studios|RPG
Age of Empires II: Definitive Edition|Forgotten Empires,Tantalus Media,Wicked Witch|Strategy
Black Mesa|Crowbar Collective|Action,Adventure,Indie
Katana ZERO|Askiisoft|Action,Indie
Resident Evil Village|CAPCOM Co., Ltd.|Action
Sea of Thieves|Rare Ltd|Action,Adventure
POSTAL 2|Running With Scissors|Action,Adventure,Indie
Rise of the Tomb Raider‚Ñ¢|Crystal Dynamics,Eidos-Montr√©al,Feral Interactive (Mac),Feral Interactive (Linux),Nixxes|Action,Adventure
Arma 3|Bohemia Interactive|Action,Simulation,Strategy
Persona 4 Golden|ATLUS|RPG
The Walking Dead|Telltale Games|Adventure
South Park‚Ñ¢: The Stick of Truth‚Ñ¢|Obsidian Entertainment|Action,Adventure,RPG
Enter the Gungeon|Dodge Roll|Action,Adventure,Indie
To the Moon|Freebird Games|Adventure,Indie,RPG
Apex Legends‚Ñ¢|Respawn Entertainment|Action,Adventure,Free to Play
OMORI|OMOCAT, LLC|Adventure,Indie,RPG
Path of Exile|Grinding Gear Games|Action,Adventure,Free to Play,Indie,Massively Multiplayer,RPG
A Hat in Time|Gears for Breakfast|Adventure,Indie
Devil May Cry 5|CAPCOM Co., Ltd.|Action
God of War|Santa Monica Studio|Action,Adventure,RPG
Saints Row: The Third|Volition|Action
Red Dead Redemption 2|Rockstar Games|Action,Adventure
Papers, Please|Lucas Pope|Adventure,Indie
Beat Saber|Beat Games|Indie
FTL: Faster Than Light|Subset Games|Indie,Simulation,Strategy
GRIS|Nomada Studio|Adventure,Indie
Ravenfield|SteelRaven7|Action,Indie,Early Access
Total War: WARHAMMER II|CREATIVE ASSEMBLY,Feral Interactive (Mac),Feral Interactive (Linux)|Action,Strategy
Stick Fight: The Game|Landfall West|Action,Casual,Indie
Broforce|Free Lives|Action,Adventure,Casual,Indie
Little Nightmares|Tarsier Studios|Adventure
SCP: Secret Laboratory|Northwood Studios|Action,Free to Play
DOOM Eternal|id Software|Action
Stray|BlueTwelve Studio|Adventure,Indie
Gunfire Reborn|Duoyi Games|Action,Adventure,Indie,RPG
Aim Lab|Statespace|Action,Adventure,Casual,Free to Play,Indie,Simulation,Early Access
Everlasting Summer|Soviet Games|Adventure,Casual,Free to Play,Indie
The Henry Stickmin Collection|PuffballsUnited|Adventure,Casual,Indie
Project Zomboid|The Indie Stone|Indie,RPG,Simulation,Early Access
Insurgency|New World Interactive|Action,Indie,Strategy
Killing Floor|Tripwire Interactive|Action
Ori and the Blind Forest: Definitive Edition|Moon Studios GmbH|Action
ULTRAKILL|Arsi Hakita Patala|Action,Indie,Early Access
Soundpad|Leppsoft|Audio Production,Utilities
The Binding of Isaac|Edmund McMillen,Florian Himsl|Action,Adventure,Indie,RPG
Resident Evil 7 Biohazard|CAPCOM Co., Ltd.|Action,Adventure
7 Days to Die|The Fun Pimps|Action,Adventure,Indie,RPG,Simulation,Strategy,Early Access
Kenshi|Lo-Fi Games|Action,Indie,RPG,Simulation,Strategy
Scrap Mechanic|Axolot Games|Action,Adventure,Indie,Simulation,Early Access
Batman: Arkham Asylum Game of the Year Edition|Rocksteady Studios|Action,Adventure
This War of Mine|11 bit studios|Adventure,Indie,Simulation
Grim Dawn|Crate Entertainment|Action,Adventure,Indie,RPG
OneShot|Future Cat LLC|Adventure,Casual,Indie
Batman: Arkham City - Game of the Year Edition|Rocksteady Studios|Action,Adventure
Cookie Clicker|Orteil,DashNet|Casual,Indie,Simulation,Strategy
Muse Dash|peropero|Action,Casual,Indie
Teardown|Tuxedo Labs|Action,Indie,Simulation,Strategy
METAL GEAR RISING: REVENGEANCE|PlatinumGames|Action
Monster Hunter: World|CAPCOM Co., Ltd.|Action
Blender|Blender Foundation|Animation & Modeling,Design & Illustration,Video Production
Ori and the Blind Forest|Moon Studios GmbH|Action
Darkest Dungeon¬Æ|Red Hook Studios|Indie,RPG,Strategy
Destiny 2|Bungie|Action,Adventure,Free to Play
Left 4 Dead|Valve|Action
Disco Elysium - The Final Cut|ZA/UM|RPG
Splitgate|1047 Games|Action,Free to Play,Indie
Yakuza 0|SEGA|Action,Adventure,RPG
Crusader Kings III|Paradox Development Studio|RPG,Simulation,Strategy
Farming Simulator 19|Giants Software|Simulation
VA-11 Hall-A: Cyberpunk Bartender Action|Sukeban Games|Adventure,Indie,Simulation
Firework|Shiying Studio|Indie
Besiege|Spiderling Studios|Indie,Simulation
INSIDE|Playdead|Action,Adventure,Indie
Paladins¬Æ|Evil Mojo Games|Action,Free to Play
CarX Drift Racing Online|CarX Technologies, LLC|Massively Multiplayer,Racing,Simulation,Sports
Noita|Nolla Games|Action,Adventure,Indie,RPG,Simulation
The Wolf Among Us|Telltale|Action,Adventure,Casual
Mafia II (Classic)|2K Czech|Action
Ultimate Custom Night|Scott Cawthon|Action,Free to Play,Indie
Grimm|Spicyhorse Games|Casual,Indie
STAR WARS‚Ñ¢ Empire at War - Gold Pack|Petroglyph|Strategy
ASTRONEER|System Era Softworks|Adventure,Indie
House Flipper|Empyrean|Indie,Simulation
Duck Game|Landon Podbielski|Action,Indie
ARK: Survival Evolved|Studio Wildcard,Instinct Games,Efecto Studios,Virtual Basement LLC|Action,Adventure,Indie,Massively Multiplayer,RPG
The Long Dark|Hinterland Studio Inc.|Adventure,Indie,Simulation,Strategy
XCOM: Enemy Unknown|Firaxis Games,Feral Interactive (Linux)|Strategy
Blade and Sorcery|WarpFrog|Action,Adventure,Indie,RPG,Simulation,Early Access
Mount & Blade II: Bannerlord|TaleWorlds Entertainment|Action,RPG,Simulation,Strategy,Early Access
Half-Life 2: Episode Two|Valve|Action
Middle-earth‚Ñ¢: Shadow of Mordor‚Ñ¢|Monolith Productions|nan
Grand Theft Auto: San Andreas|Rockstar Games|Action
Forza Horizon 4|Playground Games|Racing
The Elder Scrolls IV: Oblivion¬Æ Game of the Year Edition|Bethesda Game Studios|RPG
The Elder Scrolls IV: Oblivion¬Æ Game of the Year Edition Deluxe|Bethesda Game Studios¬Æ|nan
Star Wars: Battlefront 2 (Classic, 2005)|Pandemic Studios|Action
Shadow Tactics: Blades of the Shogun|Mimimi Games|Indie,Strategy
PowerWash Simulator|FuturLab|Casual,Indie,Simulation
Tabletop Simulator|Berserk Games|Casual,Indie,RPG,Simulation,Strategy
Outer Wilds|Mobius Digital|Action,Adventure
Dead by Daylight|Behaviour Interactive Inc.|Action
Frostpunk|11 bit studios|Simulation,Strategy
Plague Inc: Evolved|Ndemic Creations|Casual,Indie,Simulation,Strategy
Bastion|Supergiant Games|Action,Indie,RPG
Love Is All Around|intiny|Adventure,Indie,RPG,Simulation,Strategy
SOMA|Frictional Games|Action,Adventure,Indie
Assassin's Creed¬Æ Odyssey|Ubisoft Quebec,Ubisoft Montreal,Ubisoft Bucharest,Ubisoft Singapore,Ubisoft Montpellier,Ubisoft Kiev,Ubisoft Shanghai|Action,Adventure,RPG
Game Dev Tycoon|Greenheart Games üíö|Casual,Indie,Simulation,Strategy
Ultimate Chicken Horse|Clever Endeavour Games|Action,Casual,Indie
Assetto Corsa|Kunos Simulazioni|Indie,Racing,Simulation,Sports
PC Building Simulator|Claudiu Kiss,The Irregular Corporation|Indie,Simulation
DARK SOULS‚Ñ¢: Prepare To Die‚Ñ¢ Edition|FromSoftware|Action,RPG
Ready or Not|VOID Interactive|Action,Adventure,Indie,Early Access
STAR WARS Jedi: Fallen Order‚Ñ¢|Respawn Entertainment|Action,Adventure
Brothers - A Tale of Two Sons|Starbreeze Studios AB|Action,Adventure,Indie
HuniePop|HuniePot|Indie,RPG,Simulation,Strategy
Detroit: Become Human|Quantic Dream|Action,Adventure
A Plague Tale: Innocence|Asobo Studio|Action,Adventure
Tom Clancy's Rainbow Six¬Æ Siege|Ubisoft Montreal|Action
Tom Clancy's Rainbow Six¬Æ Siege|Ubisoft Montreal|Action
My Summer Car|Amistech Games|Indie,Racing,Simulation,Early Access
Tom Clancy's Rainbow Six¬Æ Siege|Ubisoft Montreal|Action
Tom Clancy's Rainbow Six¬Æ Siege|Ubisoft Montreal|Action
METAL GEAR SOLID V: THE PHANTOM PAIN|Konami Digital Entertainment|Action,Adventure
A Dance of Fire and Ice|7th Beat Games|Indie
Brawlhalla|Blue Mammoth Games|Action,Free to Play,Indie
Spec Ops: The Line|YAGER|Action,Adventure
Stellaris|Paradox Development Studio|Simulation,Strategy
Call of Duty¬Æ: Modern Warfare¬Æ 2 (2009)|Infinity Ward|Action
Hotline Miami 2: Wrong Number|Dennaton Games|Action,Indie
Mad Max|Avalanche Studios|Action,Adventure
Subnautica: Below Zero|Unknown Worlds Entertainment|Adventure,Indie
HITMAN‚Ñ¢ 2|IO Interactive A/S|Action
Far Cry 3|Ubisoft Montreal, Massive Entertainment, and Ubisoft Shanghai|Action,Adventure
LIMBO|Playdead|Action,Adventure,Indie
Alien: Isolation|Creative Assembly,Feral Interactive (Mac),Feral Interactive (Linux)|Action
Hogwarts Legacy|Avalanche Software|Action,Adventure,RPG
Resident Evil 4|CAPCOM Co., Ltd.|Action,Adventure
Bloodstained: Ritual of the Night|ArtPlay|Action,Adventure,RPG
What Remains of Edith Finch|Giant Sparrow|Adventure,Indie
Total War: MEDIEVAL II ‚Äì Definitive Edition|CREATIVE ASSEMBLY,Feral Interactive (Mac),Feral Interactive (Linux)|Strategy
Mirror 2: Project X|KAGAMI ‚Ö° WORKs|Adventure,Indie,RPG,Early Access
Pavlov VR|Vankrupt Games|Action,Indie,Early Access
NARUTO SHIPPUDEN: Ultimate Ninja STORM 4|CyberConnect2 Co. Ltd.|Action,Adventure
Fall Guys|Mediatonic|Action,Casual,Indie,Massively Multiplayer,Sports
Blood and Bacon|Big Corporation|Action,Adventure,Casual
Saints Row IV|Deep Silver Volition|Action,Adventure
Call of Juarez: Gunslinger|Techland|Action
Super Meat Boy|Team Meat|Indie
Space Engineers|Keen Software House|Action,Indie,Simulation,Strategy
F1¬Æ 2020|Codemasters|Racing,Simulation,Sports
Torchlight II|Runic Games|Action,Adventure,Indie,RPG
Sleeping Dogs: Definitive Edition|United Front Games,Feral Interactive (Mac)|Action,Adventure,Racing
Minion Masters|BetaDwarf|Action,Adventure,Free to Play,Indie,RPG,Strategy
S.T.A.L.K.E.R.: Shadow of Chernobyl|GSC Game World|Action,RPG
Amnesia: The Dark Descent|Frictional Games|Action,Adventure,Indie
Total War: SHOGUN 2|CREATIVE ASSEMBLY,Feral Interactive (Mac),Feral Interactive (Linux)|Strategy
Super Animal Royale|Pixile|Action,Adventure,Casual,Free to Play,Indie,Massively Multiplayer
PAYDAY‚Ñ¢ The Heist|OVERKILL Software|Action
Squad|Offworld Industries|Action,Indie,Strategy
Phoenix Wright: Ace Attorney Trilogy|CAPCOM Co., Ltd.|Adventure
Crypt of the NecroDancer|Brace Yourself Games|Action,Indie,RPG
SpeedRunners|DoubleDutch Games|Action,Casual,Indie,Racing,Sports
Planet Coaster|Frontier Developments,Aspyr (Mac)|Action,Adventure,Casual,Simulation,Strategy
Days Gone|Bend Studio|Action,Adventure
Transistor|Supergiant Games|Action,Indie,RPG
Prison Architect|Double Eleven,Introversion Software|Indie,Simulation,Strategy
Crusader Kings II|Paradox Development Studio|Free to Play,RPG,Simulation,Strategy
Hellblade: Senua's Sacrifice|Ninja Theory|Action,Adventure,Indie
The Stanley Parable|Galactic Cafe|Adventure,Indie
The Witcher 2: Assassins of Kings Enhanced Edition|CD PROJEKT RED|RPG
BioShock‚Ñ¢|2K Boston,2K Australia|Action,RPG
Killing Floor 2|Tripwire Interactive|Action
Skul: The Hero Slayer|SouthPAW Games|Action,Indie
SPORE‚Ñ¢|Maxis‚Ñ¢|Action,Adventure,Casual,RPG,Simulation,Strategy
Valiant Hearts: The Great War‚Ñ¢ / Soldats Inconnus : M√©moires de la Grande Guerre‚Ñ¢|Ubisoft Montpellier|Adventure
Half-Life 2: Episode One|Valve|Action
Life is Strange: Before the Storm|Deck Nine,Feral Interactive (Mac),Feral Interactive (Linux)|Action,Adventure
DEVOUR|Straight Back Games|Indie
My Time At Portia|Pathea Games|Adventure,Casual,Indie,RPG,Simulation
theHunter: Call of the Wild‚Ñ¢|Expansive Worlds|Adventure,Simulation,Sports
Marvel's Guardians of the Galaxy|Eidos-Montr√©al|Action,Adventure
Sid Meier‚Äôs Civilization¬Æ VI|Firaxis Games,Aspyr (Mac),Aspyr (Linux)|Strategy
No More Room in Hell|No More Room in Hell Team|Action,Free to Play,Indie
DRAGON BALL Z: KAKAROT|CyberConnect2 Co. Ltd.|Action,RPG
Call of Duty: World at War|Treyarch|Action
Planet Zoo|Frontier Developments|Casual,Simulation,Strategy
Little Nightmares II|Tarsier Studios|Adventure
Resident Evil 4|Capcom|Action,Adventure
ShellShock Live|kChamp Games|Action,Casual,Indie,Massively Multiplayer,Strategy
Loop Hero|Four Quarters|Indie,RPG,Strategy
Ghostrunner|One More Level,3D Realms,Slipgate Ironworks‚Ñ¢,All in! Games|Action
Metro Exodus|4A Games|Action
Goat Simulator|Coffee Stain Studios|Casual,Indie,Simulation
Yakuza: Like a Dragon|Ryu Ga Gotoku Studio|Action,Adventure,RPG
Risk of Rain|Hopoo Games|Action,Indie,RPG
Source Filmmaker|Valve|Animation & Modeling,Video Production
The Elder Scrolls III: Morrowind¬Æ Game of the Year Edition|Bethesda Game Studios|RPG
Red Orchestra 2: Heroes of Stalingrad with Rising Storm|Tripwire Interactive|Action,Massively Multiplayer,Simulation
Rec Room|Rec Room|Adventure,Casual,Free to Play,Massively Multiplayer
Just Cause 2|Avalanche Studios|Action,Adventure
Clicker Heroes|Playsaurus|Adventure,Casual,Free to Play,Indie,RPG,Simulation,Strategy
Mass Effect‚Ñ¢ Legendary Edition|BioWare|Action,RPG
DARK SOULS‚Ñ¢: REMASTERED|QLOC|Action
Wolfenstein: The New Order|MachineGames|Action
Bright Memory: Infinite|FYQD-Studio|Action,Indie
Alien Swarm|Valve|Action
Europa Universalis IV|Paradox Development Studio,Paradox Tinto|Simulation,Strategy
DRAGON BALL FighterZ|Arc System Works|Action
Five Nights at Freddy's|Scott Cawthon|Indie,Simulation
Hitman: Absolution‚Ñ¢|Io-Interactive A/S|Action
The Witcher: Enhanced Edition Director's Cut|CD PROJEKT RED|Action,RPG
Barotrauma|FakeFish,Undertow Games|Action,Indie,Simulation,Strategy,Early Access
Car Mechanic Simulator 2018|Red Dot Games|Racing,Simulation
Fallout 4|Bethesda Game Studios|RPG
DmC: Devil May Cry|Ninja Theory|Action,Adventure
Call of Duty¬Æ: Modern Warfare¬Æ 2 (2009)|Infinity Ward|Action
Forza Horizon 5|Playground Games|Action,Adventure,Racing,Simulation,Sports
Sniper Elite 4|Rebellion|Action,Adventure
Totally Accurate Battlegrounds|Landfall|Action,Free to Play,Indie
Grand Theft Auto: Vice City|Rockstar Games|Action
Golf With Your Friends|Blacklight Interactive,Team17|Casual,Indie,Sports
FINAL FANTASY XIV Online|Square Enix|Massively Multiplayer,RPG
LEGO¬Æ Star Wars‚Ñ¢: The Skywalker Saga|TT Games|Action,Adventure
Metro 2033 Redux|4A Games|Action
STAR WARS‚Ñ¢: The Old Republic‚Ñ¢|BioWare|Free to Play,Massively Multiplayer,RPG
Football Manager 2021|Sports Interactive|Simulation,Sports
Bright Memory|FYQD-Studio|Action,Adventure,Indie
Ultimate Doom|id Software|Action
Middle-earth‚Ñ¢: Shadow of War‚Ñ¢|Monolith Productions|Action,Adventure,RPG
Alan Wake|Remedy Entertainment|Action,Adventure
Firewatch|Campo Santo|Adventure,Indie
Fistful of Frags|Fistful of Frags Team|Action,Free to Play,Indie
Overcooked! 2|Ghost Town Games Ltd.,Team17|Action,Casual,Indie
Stormworks: Build and Rescue|Geometa|Simulation
BONEWORKS|Stress Level Zero|Action,Adventure,Indie,Simulation
Prey|Arkane Studios|Action,Adventure
Half-Life: Opposing Force|Gearbox Software|Action
Supreme Commander: Forged Alliance|Gas Powered Games|Strategy
Metro: Last Light Redux|4A Games|Action
Dead Space‚Ñ¢ 2|Visceral Games|Action,Adventure
Outlast 2|Red Barrels|Action,Adventure,Indie
Spyro‚Ñ¢ Reignited Trilogy|Toys for Bob,Iron Galaxy|Action,Adventure
Men of War: Assault Squad 2|Digitalmindsoft|Action,Simulation,Strategy
GUILTY GEAR -STRIVE-|Arc System Works|Action
Assassin's Creed¬Æ Origins|Ubisoft Montreal|Action,Adventure,RPG
A Story About My Uncle|Gone North Games|Adventure,Casual,Indie
Banished|Shining Rock Software LLC|Indie,Simulation,Strategy
Sonic Mania|Christian Whitehead,Headcannon,PagodaWest Games|Action,Adventure,Casual
FINAL FANTASY VII|Square Enix|RPG
STAR WARS‚Ñ¢ Knights of the Old Republic‚Ñ¢ II - The Sith Lords‚Ñ¢|Obsidian Entertainment,Aspyr (Mac, Linux, & Windows Update)|RPG
Warhammer¬Æ 40,000: Dawn of War¬Æ - Soulstorm|Relic Entertainment|Strategy
NieR:Automata‚Ñ¢|Square Enix,PlatinumGames Inc.|Action,RPG
Fallout Shelter|Bethesda Game Studios|Free to Play,RPG,Simulation
Two Point Hospital|Two Point Studios|Indie,Simulation
Deus Ex: Human Revolution - Director's Cut|Eidos Montreal|Action,RPG
Forager|HopFrog|Action,Adventure,Indie,Simulation
Horizon Zero Dawn‚Ñ¢ Complete Edition|Guerrilla|Action,Adventure,RPG
AdVenture Capitalist|Hyper Hippo Games|Casual,Free to Play,Indie
Insurgency: Sandstorm|New World Interactive|Action
The Sims‚Ñ¢ 4|Maxis|Casual,Simulation
The Evil Within 2|Tango Gameworks|Action,Adventure
Age of Empires¬Æ III (2007)|Ensemble Studios|Simulation,Strategy
Battlefield 1 ‚Ñ¢|DICE|Action,Massively Multiplayer
Mass Effect 2 (2010)|BioWare|RPG
Rome: Total War‚Ñ¢ - Collection|CREATIVE ASSEMBLY|Strategy
Borderlands Game of the Year|Gearbox Software|Action,RPG
Call of Duty¬Æ 4: Modern Warfare¬Æ|Infinity Ward|Action
QUAKE|id Software,Nightdive Studios,MachineGames|Action
Total War: EMPIRE ‚Äì Definitive Edition|CREATIVE ASSEMBLY,Feral Interactive (Mac),Feral Interactive (Linux)|Strategy
Titan Quest Anniversary Edition|Iron Lore Entertainment,THQ Nordic|Action,RPG
Call of Duty¬Æ: Black Ops|Treyarch|Action
Mortal Kombat¬†11|NetherRealm Studios,QLOC,Shiver|Action
Sonic Generations Collection|Devil's Details|Action
Pummel Party|Rebuilt Games|Action,Casual,Indie
STAR WARS‚Ñ¢ - Knights of the Old Republic‚Ñ¢|BioWare,Aspyr (Mac)|Adventure,RPG
Mass Effect (2007)|BioWare|Action,RPG
Borderlands 3|Gearbox Software|Action,RPG
Griftlands|Klei Entertainment|Indie
Hunt: Showdown|Crytek|Action
V Rising|Stunlock Studios|Action,Adventure,Massively Multiplayer,Early Access
Bayonetta|PlatinumGames|Action,Adventure
Sonic & All-Stars Racing Transformed Collection|Sumo Digital|Racing,Sports
Dishonored 2|Arkane Studios|Action
War Thunder|Gaijin Entertainment|Action,Free to Play,Massively Multiplayer,Simulation
DARK SOULS‚Ñ¢ II|FromSoftware, Inc|Action,RPG
Deus Ex: Game of the Year Edition|Ion Storm|Action
SUPERHOT|SUPERHOT Team|Action,Indie
Northgard|Shiro Games|Indie,Simulation,Strategy
Yakuza Kiwami 2|SEGA|Action,Adventure,RPG
Assassin's Creed 2|Ubisoft Montreal|Action,Adventure
Vampire: The Masquerade - Bloodlines|Troika Games|Action
Command & Conquer‚Ñ¢ Remastered Collection|Petroglyph,Lemon Sky Studios|Strategy
Company of Heroes|Relic Entertainment|Action,Strategy
DARK SOULS‚Ñ¢ II: Scholar of the First Sin|FromSoftware, Inc|Action,RPG
Baldur's Gate 3|Larian Studios|Adventure,RPG,Strategy,Early Access
Fallout: A Post Nuclear Role Playing Game|Interplay Inc.|RPG
Warhammer 40,000: Space Marine - Anniversary Edition|Relic Entertainment|Action
Hell Let Loose|Black Matter Pty Ltd|Action,Indie,Massively Multiplayer,Simulation,Strategy
Dragon's Dogma: Dark Arisen|Capcom|Action,Adventure,RPG
Rocksmith¬Æ 2014 Edition - Remastered|Ubisoft - San Francisco|Casual,Simulation
Total War: SHOGUN 2|CREATIVE ASSEMBLY,Feral Interactive (Mac),Feral Interactive (Linux)|Strategy
Dead Space|EA Redwood Shores|Action,Adventure
Resident Evil|CAPCOM Co., Ltd.|Action,Adventure
Total War: NAPOLEON ‚Äì Definitive Edition|CREATIVE ASSEMBLY,Feral Interactive (Mac)|Strategy
Town of Salem|BlankMediaGames|Indie,RPG,Strategy
Tales of Arise|Bandai Namco Studios Inc.|Action,RPG
Stumble Guys|Kitka Games|Action,Casual,Indie
Counter-Strike: Condition Zero|Valve|Action
A Way Out|Hazelight|Action,Adventure,Indie
Green Hell|Creepy Jar|Action,Adventure,Indie,Simulation
Football Manager 2022|Sports Interactive|Simulation,Sports
Cyberpunk 2077|CD PROJEKT RED|RPG
Football Manager 2020|Sports Interactive|Simulation,Sports
Farming Simulator 22|Giants Software|Simulation
Batman‚Ñ¢: Arkham Origins|WB Games Montreal,Splash Damage|Action,Adventure
Yakuza Kiwami|SEGA|Action,Adventure,RPG
Batman‚Ñ¢: Arkham Knight|Rocksteady Studios|Action,Adventure
The Elder Scrolls¬Æ Online|ZeniMax Online Studios|Action,Adventure,Massively Multiplayer,RPG
DRAGON BALL XENOVERSE 2|QLOC,DIMPS|Action,Adventure,Casual,Massively Multiplayer
Like a Dragon Gaiden: The Man Who Erased His Name|Ryu Ga Gotoku Studio|Action,Adventure
Warhammer¬Æ 40,000: Dawn of War¬Æ - Dark Crusade|Relic Entertainment|Strategy
Fallout 2: A Post Nuclear Role Playing Game|Black Isle Studios|RPG
Victoria II|Paradox Development Studio|Strategy
Battlefield 4‚Ñ¢|DICE|Action
Tales of Berseria‚Ñ¢|BANDAI NAMCO Studios Inc.|Action,RPG
DiRT Rally|Codemasters,Feral Interactive (Linux),Feral Interactive (Mac)|Racing,Simulation,Sports
Warhammer: Vermintide 2|Fatshark|Action,Indie
Jurassic World Evolution|Frontier Developments|Simulation,Strategy
XCOM¬Æ 2|Firaxis Games,Feral Interactive (Mac),Feral Interactive (Linux)|Strategy
Crash Bandicoot‚Ñ¢ N. Sane Trilogy|Vicarious Visions,Iron Galaxy|Action
The Darkness II|Digital Extremes|Action
Emily is Away|Kyle Seeley|Adventure,Casual,Free to Play,Indie,Simulation
For The King|IronOak Games|Adventure,Indie,RPG,Strategy
Rising Storm 2: Vietnam|Antimatter Games,Tripwire Interactive|Action,Massively Multiplayer,Simulation,Strategy
Mafia: Definitive Edition|Hangar 13|Action,Adventure
Day of Defeat: Source|Valve|Action
Control Ultimate Edition|Remedy Entertainment|Action,Adventure
Magicka|Arrowhead Game Studios|Action,RPG
CODE VEIN|BANDAI NAMCO Studios|Action,RPG
MONSTER HUNTER RISE|CAPCOM Co., Ltd.|Action
STAR WARS‚Ñ¢ Battlefront‚Ñ¢ II|DICE|Action,Adventure
Just Cause‚Ñ¢ 3|Avalanche Studios|Action,Adventure
PAC-MAN‚Ñ¢ Championship Edition DX+|Mine Loader Software Co., Ltd.|Action
The Awesome Adventures of Captain Spirit|DONTNOD Entertainment|Adventure,Free to Play
Warhammer¬Æ 40,000: Dawn of War¬Æ - Game of the Year Edition|Relic Entertainment|Strategy
Kingdom Come: Deliverance|Warhorse Studios|Action,Adventure,RPG
Just Cause 2: Multiplayer Mod|Avalanche Studios|Action,Adventure
Nioh 2 ‚Äì The Complete Edition|KOEI TECMO GAMES CO., LTD.|Action,RPG
Child of Light|Ubisoft Montr√©al|RPG
NARUTO TO BORUTO: SHINOBI STRIKER|Soleil Ltd.|Action
Depth|Digital Confectioners|Action,Indie
Dragon Age: Origins - Ultimate Edition|BioWare|RPG
Pacify|Shawn Hitchcock|Action,Adventure,Casual,Indie,Strategy
Call of Duty¬Æ: Black Ops III|Treyarch,Aspyr (Mac)|Action,Adventure
Dota Underlords|Valve|Casual,Free to Play,Strategy
Mirror's Edge‚Ñ¢|DICE|Action,Adventure
Âè§ÂâëÂ•áË∞≠‰∏â(Gujian3)|‰∏äÊµ∑ÁÉõÈæô‰ø°ÊÅØÁßëÊäÄÊúâÈôêÂÖ¨Âè∏,Aurogon Shanghai|RPG
Call of Duty¬Æ: Modern Warfare¬Æ 3|Infinity Ward,Sledgehammer Games|Action
FINAL FANTASY IX|Square Enix|RPG
Battlerite|Stunlock Studios|Action,Free to Play
Cry of Fear|Team Psykskallar|Action,Adventure,Indie
Grounded|Obsidian Entertainment|Action,Adventure,Early Access
VRChat|VRChat Inc.|Adventure,Casual,Free to Play,Massively Multiplayer,Simulation,Sports,Early Access
Persona¬Æ 5 Strikers|ATLUS|Action,Adventure
Aliens vs. Predator‚Ñ¢|Rebellion|Action
Shadow of the Tomb Raider: Definitive Edition|Eidos-Montr√©al,Crystal Dynamics,Nixxes,Feral Interactive (Mac),Feral interactive (Linux)|Action,Adventure
Peggle Deluxe|PopCap Games, Inc.|Casual
Age of Empires IV|Relic Entertainment,World's Edge|Strategy
MORDHAU|Triternion|Action,Indie
Wreckfest|Bugbear|Action,Indie,Racing,Simulation,Sports
Call of Duty¬Æ: Black Ops II|Treyarch|Action
Bejeweled¬Æ 3|PopCap Games, Inc.|Casual,Strategy
World of Tanks Blitz|Wargaming Group Limited|Action,Free to Play,Massively Multiplayer
FINAL FANTASY X/X-2 HD Remaster|Square Enix|RPG
Temtem|Crema|Adventure,Indie,Massively Multiplayer,RPG,Early Access
DOOM II|id Software|Action
Far Cry¬Æ 5|Ubisoft Montreal,Red Storm,Ubisoft Shanghai,Ubisoft Toronto,Ubisoft Kiev|Action,Adventure
Resident Evil 5|Capcom|Action,Adventure
Max Payne 2: The Fall of Max Payne|Remedy Entertainment|Action
Max Payne 3|Rockstar Studios|Action
Motorsport Manager|Playsport Games|Racing,Simulation,Sports,Strategy
TrackMania Nations Forever|Nadeo|Racing
World of Warships|Wargaming Group Limited|Action,Free to Play,Massively Multiplayer,Simulation
ONE PIECE: PIRATE WARRIORS 4|Koei Tecmo|Action
Persona 5 Royal|ATLUS|RPG
Unreal Tournament 2004: Editor's Choice Edition|Epic Games, Inc.|Action
Verdun|M2H,Blackmill Games|Action,Indie,Massively Multiplayer,Simulation,Strategy
Red Dead Online|Rockstar Games|Action,Adventure
Mark of the Ninja: Remastered|Klei Entertainment|Action,Indie
The Lab|Valve|Free to Play
Sonic Frontiers|Sonic Team|Action,Adventure
Remnant: From the Ashes|Gunfire Games|Action,Adventure,RPG
Half-Life: Blue Shift|Gearbox Software|Action
Dragon Age: Origins|BioWare|RPG
No Man's Sky|Hello Games|Action,Adventure
Hatoful Boyfriend|Mediatonic,Hato Moa|Casual,Indie,Simulation
They Are Billions|Numantian Games|Strategy
Chivalry: Medieval Warfare|Torn Banner Studios|Action,Indie
TEKKEN 7|BANDAI NAMCO Studios Inc.|Action,Sports
Watch_Dogs¬Æ 2|Ubisoft|Action,Adventure
Unreal Tournament: Game of the Year Edition|Epic Games, Inc.|Action
Pillars of Eternity|Obsidian Entertainment|RPG
Counter-Strike: Condition Zero|Valve|Action
DRAGON QUEST¬Æ XI S: Echoes of an Elusive Age‚Ñ¢ - Definitive Edition|Square Enix|Adventure,RPG
Insaniquarium Deluxe|PopCap Games, Inc.|Casual
Ryse: Son of Rome|Crytek|Action
SMITE¬Æ|Titan Forge Games|Action,Free to Play
Valkyria Chronicles‚Ñ¢|SEGA|Action,RPG,Strategy
GTFO|10 Chambers|Action
The Isle|Afterthought LLC|Action,Adventure,Indie,Massively Multiplayer,Simulation,Early Access
Trove|gamigo US Inc.|Action,Adventure,Casual,Free to Play,Massively Multiplayer,RPG
Call of Duty¬Æ 2|Infinity Ward|Action
Battlefield: Bad Company‚Ñ¢ 2|DICE|Action
Hi-Fi RUSH|Tango Gameworks|Action
Need for Speed‚Ñ¢ Heat|Ghost Games|Action,Adventure,Racing,Sports
PlanetSide 2|Rogue Planet Games|Action,Free to Play,Massively Multiplayer
ACE COMBAT‚Ñ¢ 7: SKIES UNKNOWN|Bandai Namco Studios Inc.|Action,Simulation
F1¬Æ 2021|Codemasters|Racing,Simulation,Sports
Wolfenstein: The Old Blood|MachineGames|Action
The Sims‚Ñ¢ 3|The Sims Studio|Simulation
Company of Heroes - Legacy Edition|Relic Entertainment|Action,Strategy
DRAGON BALL XENOVERSE|DIMPS|Action
Assassin‚Äôs Creed¬Æ Brotherhood|Ubisoft Montreal|Action,Adventure
Devil May Cry 4 Special Edition|CAPCOM Co., Ltd.|Action
NieR Replicant‚Ñ¢ ver.1.22474487139...|Square Enix,Toylogic Inc.|Action,Adventure,RPG
Warhammer 40,000: Dawn of War II: Retribution|Relic Entertainment,Feral Interactive (Mac/Linux)|Strategy
Realm of the Mad God Exalt|Wild Shadow Studios,Deca Games|Action,Free to Play,Indie,Massively Multiplayer,RPG
Okami HD|CAPCOM Co., Ltd.|Adventure
DiRT Rally 2.0|Codemasters|Racing,Simulation,Sports
Total War‚Ñ¢: ROME II - Emperor Edition|CREATIVE ASSEMBLY|Strategy
Call of Duty¬Æ: Black Ops|Treyarch|Action
Getting Over It with Bennett Foddy|Bennett Foddy|Action
The Last Campfire|Hello Games|Adventure,Indie
Return to Castle Wolfenstein|Gray Matter Studios|Action
Fishing Planet|Fishing Planet LLC|Free to Play,Massively Multiplayer,Simulation,Sports
Life is Strange: True Colors|Deck Nine|Action,Adventure
Mortal Kombat X|NetherRealm Studios,QLOC|Action
The Great Ace Attorney Chronicles|CAPCOM Co., Ltd.|Adventure
Dark Messiah of Might & Magic|Arkane Studios|Action,RPG
BioShock¬Æ 2|2K Marin,2K China,Digital Extremes,2K Australia|Action
Call of Duty¬Æ: Black Ops II|Treyarch|Action
NARUTO SHIPPUDEN: Ultimate Ninja STORM 3 Full Burst HD|CyberConnect2 Co. Ltd.|Action,Adventure
Far Cry 3 - Blood Dragon|Ubisoft Montreal|Action,Adventure
Half-Life 2: Deathmatch|Valve|Action
DOOM 64|id Software,Nightdive Studios|Action
Yu-Gi-Oh! Duel Links|Konami Digital Entertainment|Free to Play,Strategy
Sons Of The Forest|Endnight Games Ltd|Action,Adventure,Indie,Simulation,Early Access
Five Nights at Freddy's: Security Breach|Steel Wool Studios|Action,Adventure,Indie
FIFA 22|EA Canada & EA Romania|Simulation,Sports
Ultra Street Fighter¬Æ IV|Capcom|Action
NARAKA: BLADEPOINT|24 Entertainment|Action,Adventure,Massively Multiplayer
Overlord‚Ñ¢|Triumph Studios|RPG
L.A. Noire|Team Bondi,Rockstar Leeds|Adventure,Strategy
Hand Simulator|HFM Games|Simulation
Sonic Adventure DX|SEGA|nan
Call of Duty¬Æ|Infinity Ward|Action
Far Cry¬Æ 4|Ubisoft Montreal, Red Storm, Shanghai, Toronto, Kiev|Action,Adventure
ARMORED CORE‚Ñ¢ VI FIRES OF RUBICON‚Ñ¢|FromSoftware Inc.|Action
F1 2018|Codemasters|Racing,Simulation,Sports
Dirty Bomb¬Æ|Splash Damage|Action,Free to Play
Thronebreaker: The Witcher Tales|CD PROJEKT RED|Adventure,RPG
Microsoft Flight Simulator X: Steam Edition|Microsoft Game Studios|Simulation
Dying Light 2 Stay Human|Techland|Action,Adventure,RPG
Life is Strange 2|DONTNOD Entertainment,Feral Interactive (Mac),Feral Interactive (Linux)|Adventure
Call of Duty¬Æ: Modern Warfare¬Æ 3|Infinity Ward,Sledgehammer Games|Action
Max Payne|Remedy Entertainment|Action
Command & Conquer 3: Kane's Wrath|EA Los Angeles|Strategy
Digimon Story Cyber Sleuth: Complete Edition|h.a.n.d., Inc.|RPG
Dark Messiah of Might & Magic|Arkane Studios|Action,RPG
Shadowrun Returns|Harebrained Schemes|Adventure,Indie,RPG,Strategy
Company of Heroes 2|Relic Entertainment,Feral Interactive (Mac),Feral Interactive (Linux)|Strategy
Hot Lava|Klei Entertainment|Action,Adventure,Indie,Racing
The Crew‚Ñ¢ 2|Ivory Tower|Action,Massively Multiplayer,Racing
FINAL FANTASY XV WINDOWS EDITION|Square Enix|RPG
Demon Slayer -Kimetsu no Yaiba- The Hinokami Chronicles|CyberConnect2|Action,Adventure
Deceit|World Makers|Action,Free to Play,Indie
FINAL FANTASY|Square Enix|RPG
Conan Exiles|Funcom|Action,Adventure,Massively Multiplayer,RPG,Simulation,Strategy
Pillars of Eternity II: Deadfire|Obsidian Entertainment|RPG
STAR OCEAN THE SECOND STORY R|Square Enix,Gemdrops, Inc.|Action,RPG
Pyre|Supergiant Games|Action,Indie,RPG
Grand Theft Auto IV: The Complete Edition|Rockstar North,Rockstar Toronto|Action,Adventure
Sonic Adventure 2|SEGA|Action
Quake III Arena|id Software|Action
Warhammer 40,000: Dawn of War II|Relic Entertainment,Feral Interactive (Mac/Linux)|Strategy
Alice: Madness Returns|Spicy Horse Games|Action,Adventure
Warhammer 40,000: Dawn of War II: Retribution|Relic Entertainment,Feral Interactive (Mac/Linux)|Strategy
HITMAN‚Ñ¢|IO Interactive A/S,Feral Interactive (Linux),Feral Interactive (Mac)|Action
The Outer Worlds|Obsidian Entertainment|RPG
The Evil Within|Tango Gameworks|Action
Trials of Mana|Square Enix|RPG
Singularity‚Ñ¢|Raven Software|Action
Far Cry¬Æ Primal|Ubisoft|Action,Adventure
Surviving Mars|Haemimont Games,Abstraction|Simulation,Strategy
Burnout Paradise: The Ultimate Box|Criterion Games|Racing
Friday the 13th: The Game|IllFonic|Action
Invisible, Inc.|Klei Entertainment|Action,Indie,Strategy
Devil May Cry HD Collection|CAPCOM Co., Ltd.|Action
DRAGON QUEST BUILDERS‚Ñ¢ 2|Square Enix,KOEI TECMO GAMES CO., LTD.|Action,Adventure,RPG
Tom Clancy's Ghost Recon¬Æ Wildlands|Ubisoft Paris,Ubisoft Annecy,Ubisoft Bucharest,Ubisoft Montpellier,Ubisoft Milan,Reflections,Ubisoft Belgrade|Action,Adventure
Bully: Scholarship Edition|Rockstar New England|Action,Adventure
DayZ|Bohemia Interactive|Action,Adventure,Massively Multiplayer
Tom Clancy's Splinter Cell Chaos Theory¬Æ|Ubisoft Montreal|Action
Half-Life 2: Lost Coast|Valve|Action
Dungeon of the ENDLESS‚Ñ¢|AMPLITUDE Studios|Adventure,Indie,RPG,Strategy
Supreme Commander 2|Gas Powered Games|Strategy
Katamari Damacy REROLL|MONKEYCRAFT Co. Ltd.|Action,Casual
Assassin's Creed 2|Ubisoft Montreal|Action,Adventure
Yakuza 6: The Song of Life|Ryu Ga Gotoku Studio|Action,Adventure
Rayman¬Æ Origins|UBIart Montpellier|Action,Adventure
Grand Theft Auto III|Rockstar Games|Action
Grow Home|Reflections, a Ubisoft Studio|Adventure,Casual,Indie
Elite Dangerous|Frontier Developments|Action,Adventure,Massively Multiplayer,RPG,Simulation,Strategy
Minecraft Dungeons|Mojang Studios,‚Ä™Double Eleven|Action,Adventure,RPG
Wolfenstein 3D|id Software|Action
Lost Ark|Smilegate RPG|Action,Adventure,Free to Play,Massively Multiplayer,RPG
Eternal Return|Nimble Neuron|Free to Play,Indie,Strategy,Early Access
Albion Online|Sandbox Interactive GmbH|Free to Play,Massively Multiplayer,RPG
Gang Beasts|Boneloaf,Coatsink|Action,Adventure,Casual,Indie,Simulation
Quake Live‚Ñ¢|id Software|Action
Zuma Deluxe|PopCap Games, Inc.|Casual
State of Decay 2: Juggernaut Edition|Undead Labs|Action,RPG,Simulation
Command & Conquer 3: Tiberium Wars|EA Los Angeles|Strategy
DEATH STRANDING DIRECTOR'S CUT|KOJIMA PRODUCTIONS|Action,Adventure
Borderlands: The Pre-Sequel|2K Australia,Gearbox Software,Aspyr (Linux)|Action,RPG
Football Manager 2019|Sports Interactive|Simulation,Sports
BioShock‚Ñ¢ Remastered|2K Boston,2K Australia,Blind Squirrel,Feral Interactive (Mac)|Action,RPG
FINAL FANTASY VIII|Square Enix|RPG
BATTLETECH|Harebrained Schemes|Action,Adventure,Strategy
Day of Defeat|Valve|Action
Murdered: Soul Suspect|Airtight Games|Action,Adventure,RPG
Need for Speed‚Ñ¢ Payback|Ghost Games|Action,Adventure,Racing,Sports,Strategy
Tyranny|Obsidian Entertainment|Adventure,RPG
Dishonored¬Æ: Death of the Outsider‚Ñ¢|Arkane Studios|Action
FINAL FANTASY XII THE ZODIAC AGE|Square Enix|RPG
Resident Evil 3|CAPCOM Co., Ltd.|Action
FINAL FANTASY VII REMAKE INTERGRADE|Square Enix|Action,Adventure,RPG
Lara Croft and the Guardian of Light|Crystal Dynamics|Action,Adventure
Halo Infinite|343 Industries|Action,Free to Play
World of Tanks|Wargaming Group Limited|Action,Free to Play,Massively Multiplayer,Simulation
Saint Seiya: Soldiers' Soul|DIMPS|Action
Resident Evil 6|Capcom|Action,Adventure
ENDLESS‚Ñ¢ Legend|AMPLITUDE Studios|RPG,Strategy
Steep‚Ñ¢|Ubisoft Annecy,Ubisoft Montpellier,Ubisoft Kiev|Action,Sports
OCTOPATH TRAVELER‚Ñ¢|Square Enix,ACQUIRE Corp.|RPG
Street Fighter‚Ñ¢ 6|CAPCOM Co., Ltd.|Action,Adventure
Black Squad|VALOFE,NS STUDIO|Action,Free to Play
DOOM 3|id Software|Action
Assassin's Creed¬Æ Revelations|Ubisoft Montreal|Action,Adventure
ENDLESS‚Ñ¢ Space 2|AMPLITUDE Studios|Strategy
Shadowrun: Dragonfall - Director's Cut|Harebrained Schemes|Adventure,Indie,RPG,Strategy
Feeding Frenzy 2 Deluxe|PopCap Games, Inc.|Casual
CRSED: F.O.A.D.|Darkflow Software|Action,Free to Play,Massively Multiplayer
Trackmania United Forever|Nadeo|Racing
Lara Croft GO|Square Enix Montr√©al|Adventure
ULTIMATE MARVEL VS. CAPCOM 3|CAPCOM CO., LTD.|Action
Catherine Classic|ATLUS|Adventure
QUAKE II|id Software|Action
Hatsune Miku: Project DIVA Mega Mix+|SEGA|Action
Sonic CD|Blit Software|nan
TrackMania¬≤ Stadium|Nadeo|Racing,Sports
Thief‚Ñ¢ Gold|Looking Glass Studios|Action,Simulation
Resident Evil Revelations|Capcom|Action,Adventure
Total War: ATTILA|CREATIVE ASSEMBLY|Strategy
GWENT: The Witcher Card Game|CD PROJEKT RED|Free to Play,RPG,Strategy
Mega Man 11|CAPCOM CO., LTD.|Action
Rock of Ages|ACE Team|Action,Indie,Racing,Strategy
Crysis 2 - Maximum Edition|Crytek Studios|Action
Ring of Elysium|Aurora Studio|Action,Free to Play,Massively Multiplayer
Total War: WARHAMMER|CREATIVE ASSEMBLY,Feral Interactive (Linux),Feral Interactive (Mac)|Action,Strategy
Vanquish|PlatinumGames,Little Stone Software|Action
Tom Clancy‚Äôs Splinter Cell Blacklist|Ubisoft Toronto|Action,Adventure
Jet Set Radio|Blit Software|Action
Command & Conquer: Red Alert 3|EA Los Angeles|Strategy
Need For Speed: Hot Pursuit|Criterion Games|Racing
Fallout 3: Game of the Year Edition|Bethesda Game Studios|RPG
Plants vs. Zombies‚Ñ¢ Garden Warfare 2: Deluxe Edition|PopCap|Action,Casual,Strategy
Unravel|Coldwood Interactive|Action,Adventure
Yakuza 4 Remastered|Ryu Ga Gotoku Studio|Action,Adventure
Assassin‚Äôs Creed¬Æ Rogue|Ubisoft Sofia,Ubisoft Kiev|Action,Adventure
DRAGON QUEST¬Æ XI: Echoes of an Elusive Age‚Ñ¢ - Digital Edition of Light|Square Enix|RPG
Heroes of Might & Magic V: Tribes of the East|Nival|Strategy
Crossout|Targem Games|Action,Free to Play,Massively Multiplayer,Racing
SCARLET NEXUS|BANDAI NAMCO Studios Inc.|Action,Adventure,RPG
Wolfenstein II: The New Colossus|Machine Games|Action
Assassin's Creed‚Ñ¢: Director's Cut Edition|Ubisoft Montreal|Action,Adventure
Zeus + Poseidon|Impressions Games|Strategy
Zuma's Revenge!|PopCap Games, Inc.|Action,Casual
Doom 3: BFG Edition|id Software|Action
SEGA Mega Drive and Genesis Classics|D3T Limited|Action,Adventure,Casual,RPG
Robocraft|Freejam|Action,Free to Play,Indie,Massively Multiplayer,RPG,Simulation
The Dark Pictures Anthology: House of Ashes|Supermassive Games|Adventure
Company of Heroes: Tales of Valor|Relic Entertainment|Strategy
Remember Me|DONTNOD Entertainment|Action,Adventure
DuckTales: Remastered|WayForward|Action,Adventure,Casual
Warhammer¬Æ 40,000: Dawn of War¬Æ II Chaos Rising|Relic Entertainment,Feral Interactive (Mac/Linux)|Strategy
The Sims‚Ñ¢ 3|The Sims Studio|Simulation
The Sims‚Ñ¢ 3|The Sims Studio|Simulation
South Park‚Ñ¢: The Fractured But Whole‚Ñ¢|Ubisoft San Francisco|RPG
EA SPORTS‚Ñ¢ FIFA 21|EA Canada|Simulation,Sports
SPORE‚Ñ¢ Galactic Adventures|EA - Maxis|Action,Simulation
Super Robot Wars 30|B.B.STUDIO CO.,LTD.|RPG,Simulation,Strategy
METAL GEAR SOLID V: GROUND ZEROES|Konami Digital Entertainment|Action,Adventure
Unreal Tournament 3 Black|Epic Games, Inc.|Action
Overlord‚Ñ¢: Raising Hell|Triumph Studios|RPG
Thief‚Ñ¢ II: The Metal Age|Looking Glass Studios|Action,Simulation
Peggle‚Ñ¢ Nights|PopCap Games, Inc.|Casual
Knights of Honor|Black Sea Studios Ltd|Strategy
Klonoa Phantasy Reverie Series|MONKEYCRAFT Co. Ltd.|Action,Adventure,Casual
F1‚Ñ¢ 2017|Codemasters,Feral Interactive (Mac),Feral Interactive (Linux)|Racing,Simulation,Sports
SCUM|Gamepires|Action,Adventure,Indie,Massively Multiplayer,Early Access
Yakuza 5 Remastered|Ryu Ga Gotoku Studio|Action,Adventure
CHRONO TRIGGER¬Æ|Square Enix|RPG
Valkyria Chronicles 4 Complete Edition|SEGA|Action,RPG,Strategy
FINAL FANTASY III|Square Enix|RPG
Football Manager 2024|Sports Interactive|Simulation,Sports,Strategy
Onimusha: Warlords|CAPCOM CO., LTD|Action
Ni no Kuni‚Ñ¢ II: Revenant Kingdom|Level-5|Adventure,RPG
Resident Evil 7 Teaser: Beginning Hour|CAPCOM Co., Ltd.|Action,Adventure
Poppy Playtime|MOB Games|Action,Adventure,Indie
Dead Space|Motive|Action,Adventure
DEAD RISING¬Æ|Capcom|Action,Adventure
Black Desert|Pearl Abyss|Action,Adventure,Massively Multiplayer,RPG,Simulation,Strategy
SD GUNDAM G GENERATION CROSS RAYS|TOM CREATE,Ê†™Âºè‰ºöÁ§æ„Éà„É†„ÇØ„É™„Ç®„Ç§„Éà|RPG,Strategy
Team Fortress Classic|Valve|Action
Overlord II|Triumph Studios|RPG
Mini Ninjas|IO Interactive|Action,Adventure
Castle of Illusion|SEGA Studios Australia|Adventure,Casual
Assassin's Creed¬Æ Syndicate|Ubisoft Quebec, in collaboration with Ubisoft Annecy, Bucharest, Kiev, Montreal, Montpellier, Shanghai, Singapore, Sofia, Toronto studios|Action,Adventure
Realm Royale|Heroic Leap Games|Action,Free to Play,Early Access
Neverwinter|Cryptic Studios|Action,Adventure,Free to Play,Massively Multiplayer,RPG
Shank|Klei Entertainment|Action,Indie
Tomb Raider: Legend|Crystal Dynamics|Action,Adventure
Â§™ÂêæÁªòÂç∑ The Scroll Of Taiwu|ConchShip Games|Adventure,Casual,Indie,RPG,Strategy,Early Access
New World|Amazon Games|Action,Adventure,Massively Multiplayer,RPG
Binary Domain|Devil's Details|Action
Devil May Cry 4|Capcom|Action,Adventure
Assassin's Creed¬Æ Unity|Ubisoft|Action,Adventure
PAC-MAN 256|BANDAI NAMCO Studios Vancouver,Hipster Whale,3 Sprockets|Action
Commander Keen|id Software|Action
Project CARS 2|Slightly Mad Studios|Racing
eFootball PES 2021 SEASON UPDATE|Konami Digital Entertainment|Sports
Monster Hunter Stories 2: Wings of Ruin|CAPCOM Co., Ltd.|Adventure,RPG
Mirror's Edge‚Ñ¢ Catalyst|DICE|Action,Adventure
Battlefield V|DICE|Action
PUBG: BATTLEGROUNDS|KRAFTON, Inc.|Action,Adventure,Free to Play,Massively Multiplayer
Microsoft Flight Simulator Game of the Year Edition|Asobo Studio|Simulation
ENSLAVED‚Ñ¢: Odyssey to the West‚Ñ¢ Premium Edition|Ninja Theory|Action,Adventure
NARUTO SHIPPUDEN: Ultimate Ninja STORM Revolution|CyberConnect2 Co., Ltd.|Action,Adventure
Resident Evil 0|CAPCOM Co., Ltd.|Action,Adventure
Sword Art Online: Fatal Bullet|DIMPS|Action,RPG
Tom Clancy's Rainbow Six¬Æ 3 Gold|Red Storm Entertainment,Ubisoft Montreal|Action
Magicka 2|Pieces Interactive|Action,Adventure
Fallout 76|Bethesda Game Studios|RPG
Resident Evil Revelations 2|CAPCOM Co., Ltd.|Action,Adventure
Stranded Deep|Beam Team Games|Adventure,Indie,Early Access
Pharaoh + Cleopatra|Impressions Games|Simulation,Strategy
Crysis¬Æ 3|Crytek|Action,Adventure,Strategy
SOULCALIBUR VI|BANDAI NAMCO Studios Inc.,Dimps Corporation|Action
Shadowrun: Hong Kong - Extended Edition|Harebrained Schemes|Adventure,Indie,RPG,Strategy
Fallout 3|Bethesda Game Studios|RPG
Heretic: Shadow of the Serpent Riders|Raven Software|Action
MY HERO ONE'S JUSTICE 2|BYKING|Action
Heroes of Might & Magic V|Nival|Strategy
Grow Up|Reflections, a Ubisoft Studio|Adventure,Casual,Indie
Crysis 2 - Maximum Edition|Crytek Studios|Action
Total War: THREE KINGDOMS|CREATIVE ASSEMBLY,Feral Interactive (Mac),Feral Interactive (Linux)|Action,Strategy
Judgment|Ryu Ga Gotoku Studio|Action,Adventure
Tom Clancy's Ghost Recon¬Æ|Red Storm Entertainment|Action
XIII - Classic|Ubisoft Paris Studio|Action
Tony Hawk's‚Ñ¢ Pro Skater‚Ñ¢ 1 + 2|Vicarious Visions,Iron Galaxy Studios|Sports
Super Mega Baseball 3|Metalhead Software Inc.|Action,Free to Play,Indie,Simulation,Sports
NARUTO SHIPPUDEN: Ultimate Ninja STORM 2|CyberConnect2 Co. Ltd.|Action,Adventure,Strategy
F1 2016|Codemasters,Feral Interactive (Mac)|Racing,Simulation,Sports
DiRT 4|Codemasters,Feral Interactive (Mac),Feral Interactive (Linux)|Racing,Simulation,Sports
Castlevania Advance Collection|Konami Digital Entertainment|Action
Unreal Gold|Epic Games, Inc.|Action
The Typing of The Dead: Overkill|Modern Dream|Action
Supreme Commander|Gas Powered Games|Strategy
DeathSpank|Hothead Games|Action,Indie,RPG
Rocksmith‚Ñ¢|Ubisoft - San Francisco|Casual,Simulation
Caesar‚Ñ¢ 3|Impressions Games|Simulation,Strategy
Deus Ex: Mankind Divided|Eidos Montreal,Feral Interactive (Linux),Feral Interactive (Mac)|Action,RPG
.hack//G.U. Last Recode|CyberConnect2|RPG
DEATHLOOP|Arkane Studios|Action
Far Cry¬Æ New Dawn|Ubisoft Montreal,Ubisoft Kiev,Ubisoft Shanghai|Action,Adventure
Brothers in Arms: Hell's Highway‚Ñ¢|Gearbox Software|Action
Tales of Symphonia|BANDAI NAMCO Entertainment Inc.|RPG
Tom Clancy's Rainbow Six¬Æ Vegas 2|Ubisoft Montreal|Action
Lost in Random‚Ñ¢|Zoink,Thunderful|Action,Adventure,Indie
Darkest Hour: A Hearts of Iron Game|Martin Ivanov|Strategy
Tales of Zestiria|BANDAI NAMCO Studio Inc.|RPG
Shank|Klei Entertainment|Action,Indie
Shenmue I & II|D3T|Action,Adventure,RPG
Age of Wonders III|Triumph Studios|RPG,Strategy
Crysis|Crytek|Action
GUN‚Ñ¢|Neversoft|Action
Street Legal Racing: Redline v2.3.1|Invictus Games Ltd.,ImageCode|Racing,Simulation
Beyond Good and Evil‚Ñ¢|Ubisoft|Action,Adventure
Shin Megami Tensei III Nocturne HD Remaster|ATLUS|RPG
Medieval II: Total War‚Ñ¢ Kingdoms|The Creative Assembly,Feral Interactive (Mac),Feral Interactive (Linux)|Strategy
FOR HONOR‚Ñ¢|Ubisoft Montreal,Ubisoft Quebec,Ubisoft Toronto,Blue Byte|Action
Mega Man Legacy Collection|Capcom|Action
Little Goody Two Shoes|AstralShift|Adventure,RPG
UNO|Ubisoft Entertainment|Casual
Far Cry¬Æ|Crytek Studios|Action
Quake 4|RavenSoft / id Software|Action
Hell Yeah! Wrath of the Dead Rabbit|Arkedo|Action
Yu-Gi-Oh! Legacy of the Duelist|Other Ocean Interactive|Simulation
Warhammer¬Æ 40,000: Dawn of War¬Æ ‚Äì Winter Assault|Relic Entertainment|Strategy
Puyo Puyo‚Ñ¢Tetris¬Æ|Sonic Team,Bitbaboon|Action,Casual
Project CARS|Slightly Mad Studios|Racing,Simulation,Sports
Tomb Raider I|Core Design|Action,Adventure
Knights of Pen and Paper 2|Kyy Games|Adventure,Indie,RPG,Simulation,Strategy
Heroes¬Æ of Might & Magic¬Æ III - HD Edition|Dotemu|RPG,Strategy
Heroes & Generals|TLM Partners|Action,Free to Play,Indie,Massively Multiplayer,Strategy
DeathSpank|Hothead Games|Action,Indie,RPG
Castlevania: Lords of Shadow 2|MercurySteam|Action,Adventure
Condemned: Criminal Origins|Monolith|Action
Ni no Kuni Wrath of the White Witch‚Ñ¢ Remastered|LEVEL-5,QLOC|Action,Adventure,RPG
Tom Clancy‚Äôs The Division‚Ñ¢|Massive Entertainment|Action,Adventure,RPG
Age of Wonders 4|Triumph Studios|Strategy
CRISIS CORE ‚ÄìFINAL FANTASY VII‚Äì REUNION|Square Enix,TOSE CO., LTD.|Action,RPG
Chuzzle Deluxe|PopCap Games, Inc.|Casual
Company of Heroes: Opposing Fronts|Relic Entertainment|Action,Strategy
Space Channel 5: Part 2|SEGA|Action
ENDLESS‚Ñ¢ Space - Definitive Edition|AMPLITUDE Studios|Strategy
Geometry Wars‚Ñ¢ 3: Dimensions Evolved|Lucid Games,Aspyr (Linux)|Action
Tom Clancy's Splinter Cell¬Æ|Ubisoft|Action
Ghostwire: Tokyo|Tango Gameworks|Action
GOD EATER 3|BANDAI NAMCO Studios Inc.|Action
Prototype‚Ñ¢|Radical Entertainment|Action,Adventure
Prince of Persia¬Æ: The Sands of Time|Kudosoft|Action,Adventure
Crazy Taxi|SEGA|Action,Racing
Starfield|Bethesda Game Studios|RPG
Watch_Dogs‚Ñ¢|Ubisoft|Action,Adventure
One Piece Pirate Warriors 3|KOEI TECMO GAMES CO., LTD.|Action
RAGE|id Software|Action
Warlock - Master of the Arcane|Ino-Co Plus|Strategy
Crysis Warhead¬Æ|Crytek|Action
SPORE‚Ñ¢ Creepy & Cute Parts Pack|Maxis‚Ñ¢|Simulation
Chippy|Facepunch Studios|Action,Indie
Silent Hunter¬Æ III|Ubisoft|Simulation
Need for Speed‚Ñ¢ Most Wanted|Criterion Games|Action,Adventure,Racing
FINAL FANTASY VI|Square Enix|RPG
Anno 1800|Blue Byte|Simulation,Strategy
Command & Conquer: Red Alert 3 - Uprising|EA Los Angeles|Strategy
SimCity‚Ñ¢ 4 Deluxe Edition|EA - Maxis,Aspyr (Mac)|Simulation,Strategy
Bejeweled 2 Deluxe|PopCap Games, Inc.|Casual
Duelyst|Counterplay Games Inc.|Free to Play,Indie,Strategy
Rock of Ages 2: Bigger & Boulder‚Ñ¢|ACE Team|Action,Indie,Racing,Strategy
Pentiment|Obsidian Entertainment|Adventure,Casual
Far Cry¬Æ 2|Ubisoft Montreal|Action
Tomb Raider: Anniversary|Crystal Dynamics|Action,Adventure
Battlefield: Bad Company 2 Vietnam|DICE|Action
Battlefield: Bad Company 2 Vietnam|DICE|Action
Teleglitch: Die More Edition|Test3 Projects|Action,Indie
Quake Champions|id Software|Action,Free to Play,Early Access
Sword Art Online: Hollow Realization Deluxe Edition|AQURIA|Action,Adventure,Casual,RPG
Majesty Gold HD|Cyberlore|Strategy,Simulation
Tomb Raider II|Core Design|Action,Adventure
Castlevania: Lords of Shadow ‚Äì Ultimate Edition|MercurySteam,Climax Studios|Action,Adventure
QUAKE Mission Pack 1: Scourge of Armagon|Ritual Entertainment|Action
Aperture Hand Lab|Cloudhead Games ltd.|Adventure
The Deadly Tower of Monsters|ACE Team|Action,Adventure,Indie
Unravel Two|Coldwood Interactive|Action,Adventure
Hatoful Boyfriend: Holiday Star|Mediatonic|Adventure,Indie
Circuit Superstars|Original Fire Games|Action,Casual,Indie,Racing,Simulation,Sports
Renegade Ops|Avalanche Studios|Action
Cobalt|Oxeye Game Studio|Action,Adventure,Indie
FINAL FANTASY IV|Square Enix|RPG
F1 2014|Codemasters|Racing,Sports
We Love Katamari REROLL+ Royal Reverie|MONKEYCRAFT Co. Ltd.|Action
Warface|MY.GAMES|Action,Adventure,Free to Play,Massively Multiplayer,RPG,Simulation,Strategy
Super Mega Baseball: Extra Innings|Metalhead Software Inc.|Indie,Simulation,Sports
OCTOPATH TRAVELER II|Square Enix,ACQUIRE Corp.|RPG
Ricochet|Valve|Action
Quest for Glory 1-5|Sierra|Adventure
Knights of Pen and Paper +1 Edition|Behold Studios|Indie,RPG
Love Thyself - A Horatio Story|AMPLITUDE Studios|Casual,Indie,Simulation
Football Manager 2023|Sports Interactive|Simulation,Sports
Might & Magic: Clash of Heroes|Capybara Games|RPG,Strategy
JUMP FORCE|Spike Chunsoft Co., Ltd.|Action
Thief|Eidos-Montr√©al,Feral Interactive (Mac)|Action,Adventure
Geometry Wars: Retro Evolved|Bizarre Creations|Casual
Driver¬Æ Parallel Lines|Ubisoft Reflections|Racing
Prince of Persia: Warrior Within‚Ñ¢|Ubisoft|Action,Adventure
Brothers in Arms: Road to Hill 30‚Ñ¢|Gearbox Software|Action
STRIDER‚Ñ¢ / „Çπ„Éà„É©„Ç§„ÉÄ„ÉºÈ£õÁ´ú¬Æ|Double Helix Games,Capcom|Action,Adventure
RAGE|id Software|Action
Tales of Vesperia: Definitive Edition|QLOC,BANDAI NAMCO Studios Inc.|RPG
Final Fantasy IV (3D Remake)|Square Enix,DotEmu SAS.|RPG
Age of Wonders: Planetfall|Triumph Studios|Strategy
Mass Effect‚Ñ¢: Andromeda Deluxe Edition|BioWare|Action,RPG
Yakuza 3 Remastered|Ryu Ga Gotoku Studio|Action,Adventure
Arcanum: Of Steamworks and Magick Obscura|Troika Games|RPG
Super Mega Baseball 2|Metalhead Software Inc.|Indie,Simulation,Sports
Medal of Honor: Airborne|EA Los Angeles|Action
Mega Man Battle Network Legacy Collection Vol. 1|CAPCOM Co., Ltd.|Action,RPG
Sonic & SEGA All-Stars Racing|Sumo Digital|Racing
DeadCore|5 Bits Games|Action,Indie
Mechabellum|Game River|Action,Massively Multiplayer,Simulation,Strategy,Early Access
Call of Duty: United Offensive|Gray Matter Studios|Action
Crysis Warhead¬Æ|Crytek|Action
Hitman GO: Definitive Edition|Square Enix Montr√©al|Strategy
Dead Rising 3 Apocalypse Edition|Capcom Game Studio Vancouver|Action
Academia : School Simulator|Squeaky Wheel Studio Inc|Indie,Simulation,Strategy
Alpha Protocol‚Ñ¢|Obsidian Entertainment|Action,RPG
Coffee flavor of love ÂíñÂï°ÁîúÊÅã|P.G.Âà∂‰ΩúÁªÑ,V.P. TEAM|Adventure,Casual,Indie,RPG
The Last Remnant‚Ñ¢|Square Enix|RPG
Prototype 2|Radical Entertainment|Action,Adventure
Are you ready for Valve Index?|Valve|nan
SaGa Frontier Remastered|Square Enix,Bullets|RPG
The Disney Afternoon Collection|Capcom,Digital Eclipse|Action
Quantum Conundrum|Airtight Games|Casual,Strategy
Super Monkey Ball Banana Mania|Ryu Ga Gotoku Studio|Action
Myst III: Exile|Presto Studios|Adventure,Casual
Mega Man Legacy Collection 2|CAPCOM CO., LTD|Action
Assassin‚Äôs Creed¬Æ III|Ubisoft Montreal|Adventure
Â§©ÈôçÈî¶È≤§ ~ My Lucky Koi|V.P. TEAM|Adventure,Casual,Indie,RPG
FINAL FANTASY¬Æ XIII|Square Enix|RPG
Final Fantasy III (3D Remake)|Square Enix|RPG
Shadow of the Tomb Raider: Definitive Edition|Eidos-Montr√©al,Crystal Dynamics,Nixxes,Feral Interactive (Mac),Feral interactive (Linux)|Action,Adventure
Shadow of the Tomb Raider: Definitive Edition|Eidos-Montr√©al,Crystal Dynamics,Nixxes,Feral Interactive (Mac),Feral interactive (Linux)|Action,Adventure
Toybox Turbos|Codemasters|Racing
Yu-Gi-Oh! Legacy of the Duelist : Link Evolution|Other Ocean Emeryville|Simulation
Shadow of the Tomb Raider: Definitive Edition|Eidos-Montr√©al,Crystal Dynamics,Nixxes,Feral Interactive (Mac),Feral interactive (Linux)|Action,Adventure
Shadow of the Tomb Raider: Definitive Edition|Eidos-Montr√©al,Crystal Dynamics,Nixxes,Feral Interactive (Mac),Feral interactive (Linux)|Action,Adventure
Shadow of the Tomb Raider: Definitive Edition|Eidos-Montr√©al,Crystal Dynamics,Nixxes,Feral Interactive (Mac),Feral interactive (Linux)|Action,Adventure
Shadow of the Tomb Raider: Definitive Edition|Eidos-Montr√©al,Crystal Dynamics,Nixxes,Feral Interactive (Mac),Feral interactive (Linux)|Action,Adventure
Etrian Odyssey HD|ATLUS|Adventure,RPG
Shadow of the Tomb Raider: Definitive Edition|Eidos-Montr√©al,Crystal Dynamics,Nixxes,Feral Interactive (Mac),Feral interactive (Linux)|Action,Adventure
Shadow of the Tomb Raider: Definitive Edition|Eidos-Montr√©al,Crystal Dynamics,Nixxes,Feral Interactive (Mac),Feral interactive (Linux)|Action,Adventure
Football Manager 2020 Touch|Sports Interactive|Simulation,Sports
Shadow of the Tomb Raider: Definitive Edition|Eidos-Montr√©al,Crystal Dynamics,Nixxes,Feral Interactive (Mac),Feral interactive (Linux)|Action,Adventure
eFootball  PES 2020|Konami Digital Entertainment|Sports
11-11 Memories Retold|Aardman Animations,Digixart|Adventure,Casual
Shadow of the Tomb Raider: Definitive Edition|Eidos-Montr√©al,Crystal Dynamics,Nixxes,Feral Interactive (Mac),Feral interactive (Linux)|Action,Adventure
Shadow of the Tomb Raider: Definitive Edition|Eidos-Montr√©al,Crystal Dynamics,Nixxes,Feral Interactive (Mac),Feral interactive (Linux)|Action,Adventure
Phantasy Star Online 2 New Genesis|SEGA|Action,Free to Play,Massively Multiplayer,RPG
Shadow of the Tomb Raider: Definitive Edition|Eidos-Montr√©al,Crystal Dynamics,Nixxes,Feral Interactive (Mac),Feral interactive (Linux)|Action,Adventure
Shank 2|Klei Entertainment|Action,Adventure,Indie
Alpha Protocol‚Ñ¢|Obsidian Entertainment|Action,RPG
Need for Speed‚Ñ¢ Hot Pursuit Remastered|Stellar Entertainment Limited|Action,Racing
NiGHTS Into Dreams|SEGA|Adventure
WORLD OF FINAL FANTASY¬Æ|Square Enix|RPG
Tomb Raider IV: The Last Revelation|Core Design|Action,Adventure
Evolve Stage 2|Turtle Rock Studios|Action,Free to Play
Dead Space‚Ñ¢ 3|Visceral Games|Action
FINAL FANTASY VI (Old ver.)|Square Enix|RPG
NEO: The World Ends with You|h.a.n.d.|Action,RPG
Tokyo Dark|Cherrymochi|Adventure
Capcom Beat 'Em Up Bundle|CAPCOM Co., Ltd.|Action
Crash Bandicoot‚Ñ¢ 4: It‚Äôs About Time|Toys for Bob,Beenox,Activision Shanghai,Hardsuit Labs,Iron Galaxy Studios|Action
Ice Lakes|Iceflake Studios|Indie,Simulation,Sports
Europa Universalis III Complete|Paradox Development Studio|Strategy
SUPER DRAGON BALL HEROES WORLD MISSION|Dimps Corporation,SAFARI GAMES Co., Ltd.|Strategy
Dragon Age‚Ñ¢ Inquisition|BioWare|Action,Adventure,RPG,Strategy
Dead Rising¬Æ 2|Capcom Vancouver|Action,Adventure
Grand Theft Auto 2|Rockstar North|Action
Midnight Club 2|Rockstar San Diego|Racing
ARCADE GAME SERIES: GALAGA|BANDAI NAMCO Studios Inc.|Action
SEGA Bass Fishing|SEGA|Simulation,Sports
Sea of Solitude|Jo-Mei Games|Adventure
LIGHTNING RETURNS‚Ñ¢: FINAL FANTASY¬Æ XIII|Square Enix|RPG
The Elder Scrolls V: Skyrim VR|Bethesda Game Studios|RPG
F1¬Æ 23|Codemasters|Racing,Sports
Dragon Age II: Ultimate Edition|BioWare|Action,Adventure,RPG
FINAL FANTASY V|Square Enix|RPG
Eastside Hockey Manager|Sports Interactive|Simulation,Sports
SHOGUN: Total War‚Ñ¢ - Collection|CREATIVE ASSEMBLY|Action,Strategy
Capcom Fighting Collection|CAPCOM Co., Ltd.|Action
Deathmatch Classic|Valve|Action
QUAKE Mission Pack 2: Dissolution of Eternity|Rogue Entertainment|Action
ARCADE GAME SERIES: PAC-MAN|BANDAI NAMCO Studios Inc.|Action
Dungeon Siege|Gas Powered Games|RPG
Football Manager 2021 Touch|Sports Interactive|Simulation,Sports
Sword of the Stars: Complete Collection|Kerberos Productions Inc.|Strategy
Final DOOM|id Software|Action
Castlevania: Lords of Shadow ‚Äì Mirror of Fate HD|MercurySteam|Action,Adventure
OUTRIDERS|People Can Fly|Action,Adventure,RPG
The Elder Scrolls¬Æ: Legends‚Ñ¢|Sparkypants Studios, LLC|Free to Play
JoJo's Bizarre Adventure: All-Star Battle R|CyberConnect2 Co. Ltd.|Action
DORAEMON  STORY OF SEASONS|Marvelous Inc.,Brownies Inc.|Casual,Simulation
Like a Dragon: Ishin!|Ryu Ga Gotoku Studio|Action,Adventure
Thief: Deadly Shadows|Ion Storm|Action
Hearts of Iron III|Paradox Development Studio|Strategy
HeXen: Beyond Heretic|Raven Software|Action
Grand Theft Auto: Episodes from Liberty City|Rockstar North / Toronto|Action
One Piece Burning Blood|Spike Chunsoft Co., Ltd.|Action
Brothers in Arms: Earned in Blood‚Ñ¢|Gearbox Software|Action
Legacy of Kain: Defiance|Crystal Dynamics|Action,Adventure
Tomb Raider III|Core Design|Action,Adventure
Age of Wonders Shadow Magic|Triumph Studios|RPG,Strategy
Need for Speed Undercover|EA Black Box|Action,Racing
Dungeons & Dragons: Chronicles of Mystara|Iron Galaxy Studios|Action,Adventure,RPG
Space Trash Scavenger|SquarePlay Games|Action,Adventure,Indie,Early Access
GOD EATER 2 Rage Burst|BANDAI NAMCO Studio,SHIFT,QLOC|Action,RPG
Shadow of the Tomb Raider: Definitive Edition|Eidos-Montr√©al,Crystal Dynamics,Nixxes,Feral Interactive (Mac),Feral interactive (Linux)|Action,Adventure
Shadow of the Tomb Raider: Definitive Edition|Eidos-Montr√©al,Crystal Dynamics,Nixxes,Feral Interactive (Mac),Feral interactive (Linux)|Action,Adventure
Shadow of the Tomb Raider: Definitive Edition|Eidos-Montr√©al,Crystal Dynamics,Nixxes,Feral Interactive (Mac),Feral interactive (Linux)|Action,Adventure
BRAVELY DEFAULT II|Square Enix,Claytechworks|Adventure,RPG
PARANORMASIGHT: The Seven Mysteries of Honjo|Square Enix|Adventure,RPG,Simulation
Counter-Strike Nexon: Studio|Valve Corporation, Nexon Korea Corporation|Action,Casual,Free to Play,Massively Multiplayer
STAR WARS‚Ñ¢: Squadrons|MOTIVE|Action,Simulation
Shadow of the Tomb Raider: Definitive Edition|Eidos-Montr√©al,Crystal Dynamics,Nixxes,Feral Interactive (Mac),Feral interactive (Linux)|Action,Adventure
Shadow of the Tomb Raider: Definitive Edition|Eidos-Montr√©al,Crystal Dynamics,Nixxes,Feral Interactive (Mac),Feral interactive (Linux)|Action,Adventure
Half-Life: Source|Valve|Action
Resident Evil 2 R.P.D. Demo|CAPCOM Co., Ltd.|Action
PAC-MAN WORLD Re-PAC|NOW PRODUCTION|Action,Adventure,Racing
Shadow of the Tomb Raider: Definitive Edition|Eidos-Montr√©al,Crystal Dynamics,Nixxes,Feral Interactive (Mac),Feral interactive (Linux)|Action,Adventure
Shadow of the Tomb Raider: Definitive Edition|Eidos-Montr√©al,Crystal Dynamics,Nixxes,Feral Interactive (Mac),Feral interactive (Linux)|Action,Adventure
Vampire: The Masquerade - Redemption|Nihilistic Software|Violent,RPG
Persona 5 Tactica|ATLUS|RPG,Strategy
ShootMania Storm|Nadeo|Action
Two Point Campus|Two Point Studios|Indie,Simulation
Anno 1404 - History Edition|Ubisoft Mainz|Simulation,Strategy
Stardeus|Kodo Linija|Indie,RPG,Simulation,Strategy,Early Access
The Dark Pictures Anthology: Man of Medan|Supermassive Games|Adventure
ONE PIECE ODYSSEY|ILCA, Inc.|Action,Adventure,Casual,RPG
MEGA MAN X DiVE Offline|CAPCOM Co., Ltd.|Action,RPG
SteamVR Performance Test|Valve|Utilities
Dead Rising 2: Off the Record|Capcom Vancouver|Action,Adventure
Persona 4 Arena Ultimax|Arc System Works,ATLUS|Action
STRANGER OF PARADISE FINAL FANTASY ORIGIN|Square Enix,KOEI TECMO GAMES CO., LTD.|Action,Adventure,RPG
Tomb Raider: Underworld|Crystal Dynamics|Action,Adventure
TrackMania¬≤ Canyon|Nadeo|Racing,Sports
BioShock‚Ñ¢ 2 Remastered|2K Marin,2K China,Digital Extremes,2K Australia,Blind Squirrel,Feral Interactive (Mac)|Action,RPG
Lost Judgment|Ryu Ga Gotoku Studio|Action,Adventure
Sword of the Stars: Complete Collection|Kerberos Productions Inc.|Strategy
STAR WARS‚Ñ¢ Battlefront|DICE|Action,Adventure,Strategy
The Quarry|Supermassive Games|Adventure
Need for Speed‚Ñ¢|Ghost Games|Action,Adventure,Racing,Simulation
Prince of Persia¬Æ|Ubisoft Montreal|Action,Adventure
Plants vs. Zombies: Battle for Neighborville‚Ñ¢|PopCap|Action,Casual,Strategy
HUMANKIND‚Ñ¢|AMPLITUDE Studios|Strategy
Call of Duty¬Æ: Black Ops III|Treyarch,Aspyr (Mac)|Action,Adventure
Street Fighter V|Capcom|Action
Call of Duty¬Æ: Black Ops III|Treyarch,Aspyr (Mac)|Action,Adventure
Steel Division: Normandy 44|Eugen Systems|Action,Simulation,Strategy
Shadow Complex Remastered|ChAIR Entertainment|Action
Total War: ROME REMASTERED|Creative Assembly,Feral Interactive|Strategy
Á∫¢Áü≥ÈÅóËøπ - Red Obsidian Remnant|Red Obsidian Studio|Action,Adventure,Indie,RPG
Marvel's Avengers|Crystal Dynamics,Eidos-Montr√©al,Nixxes|Action,Adventure,RPG
Dragon Age‚Ñ¢: Origins Awakening|BioWare|RPG
Medal of Honor‚Ñ¢|Electronic Arts|Action
Sword Art Online Re: Hollow Fragment|AQURIA Co., Ltd.|RPG
The Elder Scrolls Online - Elsweyr|Zenimax Online Studios|Massively Multiplayer,RPG
Cloudberry Kingdom‚Ñ¢|Pwnee Studios|Indie
Sword Art Online: Lost Song|Artdink|RPG
Octahedron: Transfixed Edition|Demimonde|Action,Indie
Just Cause‚Ñ¢ 3: Multiplayer Mod|nanos GbR|Violent,Action,Massively Multiplayer
Mega Man Battle Network Legacy Collection Vol. 2|CAPCOM Co., Ltd.|Action,RPG
Call of Duty¬Æ: WWII|Sledgehammer Games,Raven Software|Action
Fallout Tactics: Brotherhood of Steel|14¬∞ East|Strategy
The Crew‚Ñ¢|Ivory Tower in collaboration with Ubisoft Reflections|Action,Massively Multiplayer,Racing
Rayman Raving Rabbids‚Ñ¢|Ubisoft Bulgaria,Ubisoft Montpellier|Action,Adventure
Cold Fear‚Ñ¢|Darkworks|Action
ONE PIECE World Seeker|GANBARION Co., Ltd.|Action,Adventure
Lost Planet‚Ñ¢: Extreme Condition|CAPCOM Co., Ltd.|Action,Adventure
Z1 Battle Royale|Daybreak Game Company|Action,Adventure,Free to Play,Massively Multiplayer
Ghosts 'n Goblins Resurrection|CAPCOM Co., Ltd.|Action
NARUTO: Ultimate Ninja STORM|CyberConnect2 Co. Ltd.|Action,Adventure
Castlevania Anniversary Collection|Konami Digital Entertainment|Action,Adventure,Racing,RPG,Simulation,Sports
Star Trek‚Ñ¢: Bridge Crew|Ubisoft|Casual,RPG,Simulation
Need for Speed‚Ñ¢ Unbound|Criterion Games|Action,Racing
3rd eye|3rd eye project|Adventure
Just Dance 2017|Ubisoft Paris,Ubisoft Pune|Casual
Zork: Grand Inquisitor|Activision|Adventure
The Beast Within: A Gabriel Knight¬Æ Mystery|Sierra On-Line|Adventure
Business Tour - Board Game with Online Multiplayer|Creobit|Casual,Free to Play,Indie,Massively Multiplayer,Strategy
SUPER CRAZY RHYTHM CASTLE|Second Impact Games|Action,Adventure,Indie
Need for Speed: Shift|Slightly Mad Studios|Racing
Need for Speed‚Ñ¢ Rivals|Criterion Games|Action,Adventure,Racing
Hearts of Iron 2 Complete|Paradox Development Studio|Strategy
Voice of Cards: The Isle Dragon Roars|Square Enix|RPG,Strategy
Spear of Destiny|id Software|Action
Trials Evolution: Gold Edition|Redlynx Ltd,Ubisoft  Shangha√Ø|Action,Racing
Tom Clancy's Ghost Recon¬Æ Desert Siege‚Ñ¢|Red Storm Entertainment|Action
The Settlers¬Æ : Heritage of Kings - History Edition|Ubisoft Blue Byte|Strategy
Ghost Trick: Phantom Detective|CAPCOM Co., Ltd.|Action,Adventure
A Total War Saga: THRONES OF BRITANNIA|CREATIVE ASSEMBLY,Feral Interactive (Mac),Feral Interactive (Linux)|Action,Strategy
Half-Life Deathmatch: Source|Valve|Action
ARCADE GAME SERIES: DIG DUG|BANDAI NAMCO Studios Inc.|Action
Puyo Puyo‚Ñ¢ Tetris¬Æ 2|SEGA|Action,Casual
Mega Man Zero/ZX Legacy Collection|CAPCOM CO., LTD.|Action,RPG
Phantasmagoria|Sierra|Adventure
FINAL FANTASY¬Æ XI: Ultimate Collection Seekers Edition|Square Enix|Massively Multiplayer
Metal Wolf Chaos XD|General Arcade,FromSoftware, Inc|Action
MOTHER|Irwin Segarane|Indie
The Dark Pictures Anthology: Little Hope|Supermassive Games|Adventure
Legend of Mana|Square Enix,M2 Co., Ltd.|Action,RPG
Mega Man X Legacy Collection|CAPCOM CO., LTD|Action
MOBIUS FINAL FANTASY‚Ñ¢|Square Enix|Free to Play,RPG
Prince of Persia: The Two Thrones‚Ñ¢|Ubisoft Montreal|Action,Adventure
Etrian Odyssey III HD|ATLUS|Adventure,RPG
Black The Fall|Sand Sailor Studio|Action,Adventure,Indie
DOOM Eternal: The Ancient Gods - Part One|id Software|Action
Clatter|Facepunch Studios|Indie,Strategy
Digimon World: Next Order|HYDE, Inc.|RPG,Simulation
DeathSpank: Thongs of Virtue|Hothead Games|Action,Indie,RPG
TimeShift‚Ñ¢|Saber Interactive|Action
Mass Effect‚Ñ¢ 3 N7 Digital Deluxe Edition (2012)|BioWare|Action,RPG,Strategy
Assassin‚Äôs Creed¬Æ Chronicles: China|Climax Studios|Action,Adventure
Zork Anthology|Infocom|Adventure
Assassin's Creed Freedom Cry|Ubisoft Montreal|Action,Adventure
Cities: Skylines II|Colossal Order Ltd.|Simulation
CRIMESIGHT|Konami Digital Entertainment|Simulation,Strategy
Little Witch Academia: Chamber of Time|APLUS Co., Ltd|Action,Adventure,RPG
Call of Duty¬Æ: Advanced Warfare - Gold Edition|Sledgehammer Games,Raven Software|Action
Eets Munchies|Klei Entertainment|Casual,Indie,Simulation,Strategy
EA SPORTS‚Ñ¢ WRC|Codemasters|Racing,Simulation,Sports
ATOMEGA|Reflections, a Ubisoft Studio|Action,Indie
Arsenal of Democracy: A Hearts of Iron Game|BL-Logic|Strategy
Microsoft Maquette|Microsoft Corporation|Casual,Free to Play
Battlefield 3‚Ñ¢|DICE|Action
Tom Clancy's Rainbow Six¬Æ Vegas|Ubisoft Montreal|Action
PAC-MAN MUSEUM+|NOW PRODUCTION|Action,Casual
Mega Man X Legacy Collection 2|CAPCOM CO., LTD|Action
Tactics Ogre: Reborn|Square Enix|RPG,Simulation
Medal of Honor‚Ñ¢|Electronic Arts|Action
MY HERO ONE'S JUSTICE|Byking Inc.|Action
Grand Theft Auto|Rockstar North|Action
GET EVEN|The Farm 51|Action,Indie
Puyo Puyo Champions|Sonic Team|Casual
FINAL FANTASY II|Square Enix|RPG
FINAL FANTASY V (Old ver.)|Square Enix|RPG
Foul Play|Mediatonic|Action,Adventure,Casual,Indie
Heroes of Might & Magic V: Hammers of Fate|Nival|Strategy
HeXen II|Raven Software|Action
Sonic the Hedgehog 4 - Episode II|SEGA|Adventure
Zeno Clash 2|ACE Team|Action,Indie
The Witcher Adventure Game|CD PROJEKT RED,Can Explode|Adventure,Strategy
Tom Clancy's Splinter Cell Conviction‚Ñ¢|Ubisoft Montreal|Action
Tom Clancy's Splinter Cell Conviction‚Ñ¢ Deluxe Edition|Ubisoft Montreal|Action
Bejeweled Deluxe|PopCap Games, Inc.|Casual
Anno 2205‚Ñ¢|Blue Byte|Simulation,Strategy
Call of Duty¬Æ: Ghosts|Infinity Ward|Action
King's Quest‚Ñ¢ Collection|Sierra|Adventure
DORAEMON STORY OF SEASONS: Friends of the Great Kingdom|Marvelous Inc.|Casual,Simulation
Fe|Zoink|Action,Adventure
Cities in Motion|Colossal Order Ltd.|Simulation
TrackMania¬≤ Valley|Nadeo|Racing,Sports
Dark Sector|Digital Extremes|Action
Space Quest‚Ñ¢ Collection|Sierra|Adventure
Jade Empire‚Ñ¢: Special Edition|BioWare|RPG
Bloody Good Time|Outerlight Ltd.|Action
È¨ºË∞∑ÂÖ´Ëçí Tale of Immortal|È¨ºË∞∑Â∑•‰ΩúÂÆ§|Action,Adventure,Indie,RPG,Simulation,Early Access
Bejeweled Twist|PopCap Games, Inc.|Casual,Strategy
ARCADE GAME SERIES: Ms. PAC-MAN|BANDAI NAMCO Studios Inc.|Action
Call of Duty¬Æ: Advanced Warfare - Gold Edition|Sledgehammer Games,Raven Software|Action
Total War: WARHAMMER III|CREATIVE ASSEMBLY,Feral Interactive|Action,Strategy
Tom Clancy's EndWar‚Ñ¢|Ubisoft  Shangha√Ø|Strategy
Digimon Survive|HYDE, Inc.|RPG
Just Cause 4 Reloaded|Avalanche Studios|Action,Adventure
Wolcen: Lords of Mayhem|WOLCEN Studio|Action,Adventure,Indie,RPG
Shadow Dancer‚Ñ¢|SEGA|Action
Football Manager 2019 Touch|Sports Interactive|Simulation,Sports
Team Sonic Racing‚Ñ¢|Sumo Digital|Racing
Company of Heroes 2 - The Western Front Armies|Relic Entertainment,Feral Interactive (Mac),Feral Interactive (Linux)|Strategy
TRIANGLE STRATEGY|Square Enix,ARTDINK|RPG,Simulation,Strategy
Dungeon Siege II|Gas Powered Games|RPG
Age of Wonders|Triumph Studios|RPG,Strategy
BLACK CLOVER: QUARTET KNIGHTS|ILINX, Inc.|Action
CoH 2 - The Western Front Armies: Oberkommando West|Relic Entertainment,Feral Interactive (Mac),Feral Interactive (Linux)|Strategy
F1¬Æ 22|Codemasters|Racing,Sports
Legacy of Kain: Soul Reaver|Crystal Dynamics|Action,Adventure
LIVE A LIVE|Square Enix,historia Inc.|Adventure,RPG
Spider-Man: Far From Home Virtual Reality|CreateVR|Adventure,Free to Play
DOOM Eternal Year One Pass|id Software|Action
Dawn of War II: Retribution ‚Äì The Last Stand|Relic Entertainment,Feral Interactive (Mac/Linux)|Strategy
Surviving the Aftermath|Iceflake Studios|Simulation,Strategy
Battlestations: Midway|Eidos Interactive|Action
Spelunker Party!|Tozai Games, Inc.,O-TWO inc.|Action,Adventure
Majesty 2 Collection|1C:InoCo|Strategy
GetsuFumaDen: Undying Moon|Konami Digital Entertainment,GuruGuru|Action,Indie
GRID|Codemasters|Action,Casual,Racing,Simulation,Sports
Discovery Tour by Assassin‚Äôs Creed¬Æ: Ancient Egypt|Ubisoft Montreal|Action,Adventure,RPG
Cobalt WASD|Oxeye Game Studio|Action,Indie
A Total War Saga: TROY|CREATIVE ASSEMBLY,Feral Interactive (Mac)|Action,Simulation,Strategy
Accel World VS. Sword Art Online Deluxe Edition|ARTDINK CORPORATION|RPG
I am Setsuna|Tokyo RPG Factory|RPG
Romancing SaGa 3‚Ñ¢|Square Enix,ArtePiazza|RPG
RAGE 2|id Software,Avalanche Studios|Action
Soul Hackers 2|ATLUS|RPG
Battlestations Pacific|Eidos Studio Hungary|Action,Strategy
Tom Clancy's Ghost Recon: Future Soldier‚Ñ¢|Ubisoft Paris,Red Storm Entertainment|Action
Gabriel Knight: Sins of the Father¬Æ|Sierra On-Line|Adventure
Age of Wonders II: The Wizard's Throne|Triumph Studios|RPG,Strategy
Armored Warfare|Obsidian Entertainment|Action,Adventure,Casual,Free to Play,Indie,Massively Multiplayer,Racing,Simulation,Strategy
Master Levels for Doom II|id Software|Action
Call of Duty¬Æ: Ghosts|Infinity Ward|Action
Mr. DRILLER DrillLand|INFINITY Co., Ltd.|Casual
Bionic Commando|Capcom|Action,Adventure
SEASON OF MYSTERY: The Cherry Blossom Murders|SQUARE ENIX|Casual
Victoria 3|Paradox Development Studio|Simulation,Strategy
Tom Clancy's Ghost Recon¬Æ Island Thunder‚Ñ¢|Red Storm Entertainment|Action
Manhunt|Rockstar North|Action
ENDLESS‚Ñ¢ Dungeon|AMPLITUDE Studios|Action,Strategy
EA SPORTS FC‚Ñ¢ 24|EA Canada & EA Romania|Simulation,Sports
RAD|Double Fine Productions|Action
Far Cry¬Æ 6|Ubisoft Toronto,Ubisoft Montreal,Ubisoft Kyiv,Ubisoft Shanghai,Ubisoft Berlin|Action,Adventure
Contra Anniversary Collection|Konami Digital Entertainment|Action
Call of Duty¬Æ: Modern Warfare¬Æ Remastered|Raven Software,Beenox|Action
Actraiser Renaissance|Square Enix,Sonic Powered|Action,Simulation,Strategy
Just Cause|Avalanche Studios|Action
Hunted: The Demon‚Äôs Forge‚Ñ¢|inXile Entertainment|Action,Adventure
Persona 3 Portable|ATLUS|Adventure,RPG,Strategy
Imperator: Rome|Paradox Development Studio|Simulation,Strategy
Secret of Mana|Square Enix|Action,RPG
SONIC SUPERSTARS|SEGA|Action
The Midnight Sanctuary|CAVYHOUSE|Adventure,Indie
QUAKE III: Team Arena|id Software|Action
Call of Cthulhu¬Æ: Dark Corners of the Earth|Headfirst Productions|nan
The Centennial Case : A Shijima Story|Square Enix|Adventure
Battlefield‚Ñ¢ Hardline|DICE|Action
METAL GEAR SURVIVE|Konami Digital Entertainment|Action,Adventure,Strategy
PAC-MAN‚Ñ¢ and the Ghostly Adventures|NAMCO BANDAI Games|Action
Comix Zone‚Ñ¢|SEGA|Action
Conflict Desert Storm‚Ñ¢|Pivotal Games|Action
The Settlers¬Æ : Rise of an Empire - History Edition|Ubisoft Blue Byte|Strategy
Streets of Rage 2|SEGA|Action
Rome: Total War‚Ñ¢ - Alexander|The Creative Assembly|Strategy
Football Manager 2019: The Hashtag United Challenge|Sports Interactive|Simulation,Sports
LARA CROFT AND THE TEMPLE OF OSIRIS‚Ñ¢|Crystal Dynamics|Action,Adventure
NECROPOLIS: BRUTAL EDITION|Harebrained Schemes|Action,Adventure,Indie
Street Fighter 30th Anniversary Collection|Digital Eclipse|Action
Kane & Lynch 2: Dog Days|IO Interactive|Action
Call of Duty¬Æ: Black Ops Cold War|Treyarch,Raven Software,High Moon Studios,Beenox,Activision Shanghai,Sledgehammer Games|Action
Call of Duty¬Æ: Modern Warfare¬Æ II|Infinity Ward,Raven Software,Beenox,Treyarch,High Moon Studios,Sledgehammer Games,Activision Shanghai,Demonware,Toys for Bob|Action
PAC-MAN‚Ñ¢ CHAMPIONSHIP EDITION 2|BANDAI NAMCO Studios Inc.|Casual
QUAKE II Mission Pack: The Reckoning|Xatrix Entertainment|Action
Trials Fusion‚Ñ¢|RedLynx, in collaboration with  Ubisoft Shanghai, Ubisoft Kiev|Racing
Flock!|Proper Games|Casual,Strategy
Fallout 4 VR|Bethesda Game Studios|RPG
Homefront|Kaos Studios,Digital Extremes|Action
Battletoads|Dlala Studios|Action,Adventure
Call of Duty¬Æ: WWII|Sledgehammer Games,Raven Software|Action
FINAL FANTASY VIII - REMASTERED|Square Enix|Adventure,RPG
Zombieland VR: Headshot Fever|XR Games|Action
STAR OCEAN‚Ñ¢ - THE LAST HOPE -‚Ñ¢ 4K & Full HD Remaster|Square Enix,tri-Ace|Action,RPG
Anno 2070‚Ñ¢|Blue Byte,Related Designs|Strategy
Silent Hunter¬Æ: Wolves of the Pacific U-Boat Missions|Ubisoft Romania|Simulation
Joe Danger|Hello Games|Action,Casual,Indie,Racing
BRINK|Splash Damage|Action,Free to Play
Lost Planet¬Æ 2|CAPCOM CO., LTD.|Action,Adventure
Project: Snowblind|Crystal Dynamics|Action
Billion Road|BANDAI NAMCO Entertainment Inc.|Casual,Strategy
Shift 2 Unleashed|Slightly Mad Studios|Racing
NAMCO MUSEUM ARCHIVES Vol 2|M2 Co.,LTD|Action
Tomb Raider V: Chronicles|Core Design|Action,Adventure
I Am Alive|Ubisoft  Shangha√Ø|Action,Adventure
A Total War Saga: FALL OF THE SAMURAI|CREATIVE ASSEMBLY,Feral Interactive (Mac),Feral Interactive (Linux)|Strategy
METAL GEAR SOLID 3: Snake Eater - Master Collection Version|KONAMI|Action
Diablo¬Æ IV|Blizzard Entertainment, Inc.|Action,RPG
COH 2 - The Western Front Armies: US Forces|Relic Entertainment,Feral Interactive (Mac),Feral Interactive (Linux)|Strategy
Shining Resonance Refrain|SEGA|Adventure,RPG
Operation Flashpoint: Dragon Rising|Codemasters|Action
From Dust|Ubisoft Montpellier|Adventure,Simulation
Shining Force|SEGA|RPG
Might & Magic X - Legacy|Ubisoft|RPG
Medieval: Total War‚Ñ¢ - Collection|CREATIVE ASSEMBLY|Action,Strategy
Prince of Persia: The Forgotten Sands‚Ñ¢|Ubisoft Montreal|Action,Adventure
Sonic Forces|Sonic Team,Hardlight|Action,Adventure
MDK 2|BioWare Corporation|Action
Teenage Mutant Ninja Turtles: The Cowabunga Collection|Digital Eclipse|Action
Sonic The Hedgehog|SEGA|Action,Adventure
SWORD ART ONLINE Alicization Lycoris|AQURIA Co., Ltd.|Action,Adventure,RPG
Phantasmagoria 2: A Puzzle of Flesh|Sierra|Adventure
TEMBO THE BADASS ELEPHANT|GAME FREAK inc.|Action,Adventure,Indie
Merchant of the Six Kingdoms|Cory Long|Adventure,Casual,Indie,RPG,Strategy
Alien Soldier|SEGA|Action
NBA 2K20|Visual Concepts|Simulation,Sports
Streets of Rage|SEGA|Action
Captain Tsubasa: Rise of New Champions|TAMSOFT CORPORATION|Action,Casual,RPG,Sports
Citizens of Earth|Eden Industries|RPG
Million Arthur: Arcana Blood|Square Enix,Team ARCANA|Action
Romancing SaGa -Minstrel Song- Remastered|Square Enix,Bullets|RPG
Warlock 2: The Exiled|Ino-Co Plus|Strategy
Burnout‚Ñ¢ Paradise Remastered|Stellar Entertainment,Criterion Games|Action,Adventure,Racing
Return to Zork|Activision|Adventure
Pixel Privateers|Quadro Delta|Action,Adventure,Indie,RPG,Simulation
Spycraft: The Great Game|Activision|Adventure
DOOM Eternal: The Ancient Gods - Part Two|id Software|Action
Shining Force II|SEGA|RPG
BRINK|Splash Damage|Action,Free to Play
BRINK|Splash Damage|Action,Free to Play
TOKYO GHOUL:re [CALL to EXIST]|Three Rings Inc.|Action
Company of Heroes 2 - The British Forces|Relic Entertainment,Feral Interactive (Mac),Feral Interactive (Linux)|Strategy
GRID Legends|Codemasters|Action,Racing,Simulation,Sports
Order of War‚Ñ¢|Wargaming.net|Strategy
Kane and Lynch: Dead Men‚Ñ¢|IO Interactive|Action
PRO EVOLUTION SOCCER 2018|Konami Digital Entertainment Co., Ltd.|Sports
ZONE OF THE ENDERS THE 2nd RUNNER : M‚àÄRS / „Ç¢„Éå„Éì„Çπ „Çæ„Éº„É≥„Éª„Ç™„Éñ„Éª„Ç®„É≥„ÉÄ„Éº„Ç∫ : „Éû„Éº„Ç∫|Konami Digital Entertainment,Cygames, Inc.|Action
Trials¬Æ Rising|RedLynx|Racing
DRAGON QUEST HEROES‚Ñ¢ Slime Edition|KOEI TECMO GAMES CO., LTD.|Action,RPG
Gunstar Heroes|SEGA|Action
Call of Duty¬Æ: Infinite Warfare|Infinity Ward|Action,Adventure
Rise of the Argonauts|Liquid Entertainment|RPG
Sonic Lost World|Sonic Team|Adventure
Majesty 2|1C:InoCo|Simulation,Strategy
Immortals of Aveum‚Ñ¢|Ascendant Studios|Action,Adventure
SaGa SCARLET GRACE: AMBITIONS‚Ñ¢|Square Enix|RPG
DRAGON QUEST HEROES‚Ñ¢ II|Square Enix,KOEI TECMO GAMES CO., LTD.|Action,RPG
LOST PLANET¬Æ 3|Spark Unlimited|Action
One Piece: Unlimited World Red - Deluxe Edition|Ganbarion|Action,Adventure
Company of Heroes 3|Relic Entertainment|Action,Strategy
The Lamplighters League|Harebrained Schemes|Adventure,RPG,Strategy
ZOMBI|Straight Right|Action,Adventure
Life is Strange Remastered|Deck Nine|Action,Adventure
HeXen: Deathkings of the Dark Citadel|Raven Software|Action
Rogue Warrior|Rebellion|Action
Children of Zodiarcs|Cardboard Utopia|Indie,RPG,Strategy
Trackmania¬Æ Turbo|Nadeo|Massively Multiplayer,Racing
Golden Axe‚Ñ¢|SEGA|Action
Sumeru|BigCheeseGames|Adventure,Casual,Indie
Ê∏°Âä´ x È≠îÂ•≥ ~ Team up with A MagicianÔºÅ|V.P.TEAM|Adventure,Casual,Indie,RPG,Simulation
Silent Hunter¬Æ: Wolves of the Pacific|Ubisoft Romania|Simulation
Crack Down‚Ñ¢|SEGA|Action
Trigger Henry|PrimePhaseGames|Action,Adventure,Casual,Early Access
Ristar‚Ñ¢|SEGA|nan
Bonanza Bros.‚Ñ¢|SEGA|Action
FINAL FANTASY TYPE-0‚Ñ¢ HD|Square Enix|Action,RPG
Abyss Odyssey|ACE Team|Action,Adventure,Indie
King Arthur - The Role-playing Wargame|NeocoreGames|RPG,Strategy
Exoprimal|CAPCOM Co., Ltd.|Action
Microsoft Allegiance|Microsoft Game Studios|Action,Free to Play,Simulation,Strategy
Transference‚Ñ¢|Ubisoft|Adventure,Indie
Legacy of Kain: Soul Reaver 2|Crystal Dynamics|Action,Adventure
Marvel vs. Capcom: Infinite|Capcom|Action
PRO EVOLUTION SOCCER 2019 LITE|Konami Digital Entertainment|Sports
FINAL FANTASY¬Æ XIII-2|Square Enix|RPG
DRAGON BALL: THE BREAKERS|Dimps Corporation|Action,Adventure,Casual
Ace Combat Assault Horizon - Enhanced Edition|NAMCO|Action,Simulation
Surviving the Abyss|Rocket Flair Studios|Indie,Simulation,Strategy,Early Access
Unreal 2: The Awakening|Epic Games, Inc.|Action
Starlink: Battle for Atlas|Ubisoft Toronto|Action,Adventure
Rakion Chaos Force|Neosonyx Co., Ltd.|Action,Free to Play,RPG,Strategy
Caesar‚Ñ¢ IV|Tilted Mill Entertainment, Inc.|Simulation,Strategy
Devil May Cry¬Æ 3 Special Edition|CAPCOM Co., Ltd.|Action
Kygo 'Carry Me' VR Experience|MPC VR|Casual
STAR OCEAN THE DIVINE FORCE|Square Enix,tri-Ace|Action,RPG
Street Fighter¬Æ IV|Capcom|Action
Voodoo Dice|Exkee|Casual
Virtua Tennis 4‚Ñ¢|SEGA|Sports
Might and Magic: Heroes VII ‚Äì Trial by Fire|Limbic Entertainment|RPG,Strategy
Project CARS - Pagani Edition|Slightly Mad Studios|Racing,Simulation,Sports
Etrian Odyssey II HD|ATLUS|Adventure,RPG
An Elder Scrolls Legend: Battlespire|Bethesda Softworks|Action,RPG
VALKYRIE ELYSIUM|Square Enix,Soleil Ltd.|Action,RPG
Landstalker: The Treasures of King Nole|SEGA|RPG
Wonder Boy III: Monster Lair|SEGA|nan
Decap Attack‚Ñ¢|SEGA|nan
ToeJam & Earl|SEGA|Adventure
METAL GEAR & METAL GEAR 2: Solid Snake|KONAMI|Action
Bail or Jail|FREE STYLE, Inc.,Konami Digital Entertainment|Action,Casual,Sports
Groundhog Day: Like Father Like Son|Tequila Works|Adventure
Warp|Trapdoor Inc.|Action,Adventure,Indie
Tales of Wedding Rings VR|Square Enix|Casual
Medal of Honor‚Ñ¢: Above and Beyond|Respawn Entertainment|Action
Rocket Arena|Final Strike Games|Action,Sports
Riders Republic|Ubisoft Annecy,Ubisoft Belgrade,Ubisoft Kyiv,Ubisoft Pune,Ubisoft Odesa|Massively Multiplayer,Sports
Assassin's Creed¬Æ III Remastered|Ubisoft Entertainment|Action,Adventure
Voice of Cards: The Beasts of Burden|Square Enix|RPG
Altered Beast‚Ñ¢|SEGA|Action
Hotel Transylvania Popstic|Specular Theory|Action,Adventure,Casual,Indie,Strategy,Early Access
Omikron: The Nomad Soul|Quantic Dream|RPG
Dead Rising 4|Capcom Game Studio Vancouver, Inc.|Action
TINY METAL|AREA 35, Inc.|Indie,Simulation,Strategy
METAL GEAR SOLID 2: Sons of Liberty - Master Collection Version|KONAMI|Action
METAL GEAR SOLID - Master Collection Version|KONAMI|Action
Ê∞¥Êó∂Èíü-Water_Clock|3RISE,Ê©òÂ≠êÁè≠|Adventure,Casual,Indie,RPG
COLLECTION of SaGa FINAL FANTASY LEGEND|Square Enix,Racjin|RPG
Rocket Knight|Climax Studios|Action,Adventure
Myst IV: Revelation|Ubisoft Montreal|Adventure,Casual
Grand Theft Auto: San Andreas ‚Äì The Definitive Edition|Rockstar Games|Action,Adventure
Police Quest‚Ñ¢ Collection|Sierra|Adventure
Assassin‚Äôs Creed¬Æ Chronicles: India|Climax Studios|Action,Adventure
Light Crusader|SEGA|RPG
Space Harrier‚Ñ¢ II|SEGA|Action
Alien Storm|SEGA|Action
Beware Planet Earth|Lightmare Studio|Casual,Indie,Strategy
Star Trek: Infinite|Nimble Giant Entertainment|Adventure,Simulation,Strategy
Assassin's Creed Valhalla|Ubisoft Montreal|Action,Adventure,RPG
SD GUNDAM BATTLE ALLIANCE|ARTDINK|Action,RPG
Crown and Council|Mojang|Casual,Indie,Strategy
Dungeon Siege III|Obsidian Entertainment|Action,RPG
Artifact|Valve|Strategy
Survived By|Human Head Studios|Action,Free to Play,Indie,Massively Multiplayer,RPG,Early Access
PRO EVOLUTION SOCCER 2019|Konami Digital Entertainment|Sports
Zeit¬≤|Brightside Games|Action,Indie
Minecraft Legends|Mojang Studios,Blackbird Interactive|Action,Strategy
Zork Nemesis: The Forbidden Lands|Zombie Studios|Nudity,Violent,Adventure
Europa Universalis III: Divine Wind|Paradox Development Studio|Strategy
Total War: PHARAOH|CREATIVE ASSEMBLY|Action,Strategy
March of the Eagles|Paradox Development Studio|Simulation,Strategy
ONINAKI|Tokyo RPG Factory|Action,RPG
Might & Magic¬Æ Heroes¬Æ VII|Limbic Entertainment|RPG,Strategy
Winning Putt: Golf Online|WEBZENONNET Co., Ltd.|Free to Play,Massively Multiplayer,Simulation,Sports
Warhammer 40,000: Dawn of War III|Relic Entertainment,Feral Interactive (Mac),Feral Interactive (Linux)|Action,Simulation,Strategy
Victoria I Complete|Paradox Development Studio|Strategy
Pathfinder Adventures|Obsidian Entertainment|Violent,RPG,Strategy
Front Mission Evolved|Double Helix Games|Action
SWORD ART ONLINE Last Recollection|AQURIA Co., Ltd.|Action,Adventure,RPG
DUNGEON ENCOUNTERS|Square Enix|RPG
Petz¬Æ Horsez¬Æ 2|Ubisoft|Simulation
Cities in Motion 2|Colossal Order Ltd.|Simulation,Strategy
Fatal Labyrinth‚Ñ¢|SEGA|RPG
Madden NFL 22|Tiburon|Casual,Simulation,Sports,Strategy
Knights of Pen and Paper 2: Free Edition|Kyy Games|Indie,RPG,Simulation
Gain Ground‚Ñ¢|SEGA|Strategy
Kid Chameleon‚Ñ¢|SEGA|nan
Shinobi‚Ñ¢ III: Return of the Ninja Master|SEGA|Action
Sword of Vermilion‚Ñ¢|SEGA|RPG
Grand Theft Auto: Vice City ‚Äì The Definitive Edition|Rockstar Games|Action,Adventure
DOOM VFR|id Software|Action
Bionic Commando: Rearmed|Capcom|Action
Football Manager Touch 2018|Sports Interactive|Simulation,Sports
DIRT 5|Codemasters|Action,Adventure,Casual,Racing,Sports
Ridge Racer‚Ñ¢ Unbounded|BUGBEAR|Racing
STAR WARS Jedi: Survivor‚Ñ¢|Respawn|Action,Adventure
Pandemonium|Crystal Dynamics|nan
Sonic Origins|SEGA|Action,Adventure,Casual
Tomb Raider VI: The Angel of Darkness|Core Design|Action
Deus Ex: Invisible War|Ion Storm|Action
Resident Evil: Operation Raccoon City|Slant Six Games|Action
The Sum of All Fears|Red Storm Entertainment|Action
A Game of Dwarves|Zeal Game Studio|Casual,Strategy
Forspoken|Luminous Productions|Action,Adventure,RPG
Assassin‚Äôs Creed¬Æ Chronicles: Russia|Climax Studios|Action,Adventure
Company of Heroes 2 - Ardennes Assault|Relic Entertainment,Feral Interactive (Mac),Feral Interactive (Linux)|Strategy
Suspect Enemy|HorseGames|Action,Casual,Massively Multiplayer
Project CARS 3|Slightly Mad Studios|Racing
Marvel: Ultimate Alliance|Zo√´ Mode|Action,Adventure,RPG
Ecco the Dolphin‚Ñ¢|SEGA|Action
Street Fighter X Tekken|Capcom U.S.A., Inc.|Action
For The Glory: A Europa Universalis Game|Crystal Empire Games|Strategy
Platformines|Magiko Gaming|Action,Indie
Europa Universalis: Rome - Gold Edition|Paradox Development Studio|Strategy
Might & Magic: Heroes VI|Blackhole|RPG,Strategy
Wayfinder|Airship Syndicate|Action,Adventure,Casual,Massively Multiplayer,RPG,Early Access
FINAL FANTASY IV: THE AFTER YEARS|Square Enix|RPG
HARVESTELLA|Square Enix|Action,RPG,Simulation
Inversion‚Ñ¢|Saber Interactive|Action
Total War Battles: KINGDOM|CREATIVE ASSEMBLY|Free to Play,Strategy
Notre-Dame de Paris: Journey Back in Time|Ubisoft|Casual,Free to Play
Madden NFL 21|Electronic Arts|Simulation,Sports,Strategy
Lost Planet: Extreme Condition Colonies Edition|CAPCOM CO., LTD.|Action,Adventure
The Settlers¬Æ 7 : History Edition|Ubisoft Blue Byte|Strategy
Wolfenstein: Youngblood|Machine Games,Arkane Studios|Action
Tom Clancy‚Äôs Rainbow Six¬Æ Extraction|Ubisoft Montreal|Action
Ecco‚Ñ¢: The Tides of Time|SEGA|Adventure
Shining in the Darkness|SEGA|RPG
Flicky‚Ñ¢|SEGA|nan
Trials of the Blood Dragon|Redlynx,Ubisoft Kiev|Racing
Call of Duty¬Æ: Modern Warfare¬Æ|Infinity Ward,Beenox,High Moon Studios,Raven Software|Action
Assassin‚Äôs Creed¬Æ Liberation HD|Ubisoft Sofia|Action,Adventure
Space Junkies‚Ñ¢|Ubisoft Montpellier|Action,Sports
NAMCO MUSEUM ARCHIVES Vol 1|M2 Co.,LTD|Action
Bio-Hazard Battle‚Ñ¢|SEGA|Action
VectorMan‚Ñ¢|SEGA|Action
Romancing SaGa 2‚Ñ¢|Square Enix,ArtePiazza|RPG
Sengoku|Paradox Development Studio|RPG,Simulation,Strategy
Race Arcade|Iceflake Studios|Indie,Racing,Sports
Anniversary Collection Arcade Classics|Konami Digital Entertainment|Action,Casual
Warhammer 40,000: Kill Team|Nomad Games|Action
Empire of Sin|Romero Games|RPG,Strategy
The Elder Scrolls Online - Greymoor|Zenimax Online Studios|Action,Massively Multiplayer,RPG
PAC-MAN MUSEUM‚Ñ¢|BANDAI NAMCO Studio Inc.|Action
Trackmania¬≤ Lagoon|Nadeo|Racing,Sports
CHRONO CROSS: THE RADICAL DREAMERS EDITION|Square Enix,D4Enterprise Co.,Ltd.|Adventure,RPG
Immortals Fenyx Rising|Ubisoft|Action,Adventure,RPG
Tom Clancy‚Äôs The Division¬Æ 2|Ubisoft|Action,Adventure,RPG
GWENT: Rogue Mage (Single-Player Expansion)|CD PROJEKT RED|Strategy
Paper Dungeons Crawler|Stephane Valverde|Indie,RPG
Eagle Flight|Ubisoft Montreal Studio|Action,Simulation
BALAN WONDERWORLD|Square Enix,ARZEST Corp.|Action
MONOPOLY¬Æ PLUS|Ubisoft Pune|Casual
Rocket Jockey|Rocket Science Games,Jordan Freeman Group,SegaSoft|Action,Racing,Sports
Dr. Robotnik‚Äôs Mean Bean Machine‚Ñ¢|SEGA|Casual,Strategy
Capcom Arcade Stadium|CAPCOM Co., Ltd.|Action,Free to Play
Joe Danger 2: The Movie|Hello Games|Action,Casual,Indie,Racing
Voice of Cards: The Forsaken Maiden|Square Enix|RPG
Grand Theft Auto III ‚Äì The Definitive Edition|Rockstar Games|Action,Adventure
Werewolves Within‚Ñ¢|Ubisoft|Casual,RPG,Simulation,Strategy
Sonic 3D Blast‚Ñ¢|SEGA|nan
L.A. Noire: The VR Case Files|Rockstar Games|Action,Adventure
Super Mega Baseball‚Ñ¢ 4|Metalhead Software Inc.|Simulation,Sports
SWAT 3: Tactical Game of the Year Edition|Sierra|Violent,Action,Simulation
Ninja Blade|FromSoftware|Action
Crusader Kings Complete|Paradox Development Studio|Strategy
Tom Clancy's Ghost Recon¬Æ Breakpoint|Ubisoft Paris|Action,Adventure
Ship Simulator Extremes|VStep|Simulation
Call of Duty¬Æ: Vanguard|Sledgehammer Games,Treyarch,High Moon Studios,Raven Software,Beenox,Demonware|Action
Sonic Colors: Ultimate|Blind Squirrel Entertainment|Action,Casual
ESWAT‚Ñ¢: City Under Siege|SEGA|nan
Deadbeat Heroes|Deadbeat Productions|Action
The Elder Scrolls Online: High Isle|ZeniMax Online Studios|Action,Adventure,Massively Multiplayer,RPG
Columns‚Ñ¢|SEGA|Casual,Strategy
Prop Hunt 2.0|HorseGames|Adventure,Casual,Indie,Massively Multiplayer,RPG
Survival Quiz CITY|Bandai Namco Studios Inc.|Action,Casual,Massively Multiplayer
Call of Duty¬Æ: Ghosts - Digital Hardened Edition|Infinity Ward|Action
3D Ultra‚Ñ¢ Minigolf Adventures|Wanako Games|Sports
PRO EVOLUTION SOCCER 2018 LITE|Konami Digital Entertainment Co., Ltd|Sports
Silent Hill Homecoming|Double Helix Games|Adventure
NARUTO X BORUTO Ultimate Ninja STORM CONNECTIONS|CyberConnect2 Co., Ltd.|Action,Adventure
Tom Clancy's Rainbow Six Lockdown‚Ñ¢|Red Storm Entertainment|Action
Yosumin!‚Ñ¢|Square Enix|Casual
Viking: Battle for Asgard|Creative Assembly, PC Port - Hardlight|Action,Adventure
Battlefield‚Ñ¢ 2042|DICE|Action,Adventure,Casual
Skelattack|Ukuza, Inc.|Action,Adventure,Indie
ONE PUNCH MAN: A HERO NOBODY KNOWS|Spike Chunsoft Co. Ltd.|Action
Super Monkey Ball: Banana Blitz HD|SEGA|Action
Maelstrom: The Battle for Earth Begins|KDV Games|Strategy
Life is Strange: Before the Storm Remastered|Deck Nine|Action,Adventure
QUAKE II Mission Pack: Ground Zero|Rogue Entertainment|Action
Ecco‚Ñ¢ Jr.|SEGA|Adventure
Dark Void‚Ñ¢|Airtight Games|Action,Adventure
Watch Dogs¬Æ: Legion|Ubisoft Toronto|Action,Adventure
Sonic Spinball‚Ñ¢|SEGA|Action
Olympic Games Tokyo 2020 ‚Äì The Official Video Game‚Ñ¢|SEGA|Casual,Sports
Virtua Fighter‚Ñ¢ 2|SEGA|Action,Simulation
Super Bomberman R|Konami Digital Entertainment|Action
Scary Girl|TikGames|Action
King Arthur II: The Role-Playing Wargame|NeocoreGames|RPG,Strategy
DISSIDIA FINAL FANTASY NT Free Edition|Square Enix,KOEI TECMO GAMES CO., LTD.|Action,Free to Play
BATTLLOON - „Éê„Éà„É´„Éº„É≥|NamaTakahashi,tiny cactus studio,noname studio|Action,Indie
WILD HEARTS‚Ñ¢|KOEI TECMO GAMES CO., LTD.|Action,Adventure
The Dark Pictures Anthology: The Devil in Me|Supermassive Games|Adventure
AGOS - A Game Of Space|Ubisoft|Adventure,Simulation
LOST SPHEAR|Tokyo RPG Factory|Action,Adventure,RPG
Silent Hunter 5¬Æ: Battle of the Atlantic|Ubisoft Romania|Simulation
Spider-Man: Homecoming - Virtual Reality Experience|CreateVR|Action,Adventure
New Gundam Breaker|CRAFTS & MEISTER Co., Ltd.|Action
Golden Axe‚Ñ¢ II|SEGA|Action
ToeJam & Earl in Panic on Funkotron|SEGA|nan
Gyromancer|Square Enix,PopCap Games, Inc.|RPG
Call to Power II|Activision|Strategy
Park Beyond|Limbic Entertainment|Casual,Simulation,Strategy
Obsidian|Rocket Science Games,Jordan Freeman Group,SegaSoft|Adventure
Flora's Fruit Farm|Honeyslug|Casual
Sonic the Hedgehog 4 - Episode I|SEGA|nan
Conflict: Denied Ops|Pivotal Games|Action
SUPER BOMBERMAN R 2|KONAMI|Action,Adventure,Casual,Massively Multiplayer,RPG
Columns‚Ñ¢ III|SEGA|Casual
BlockAid|SEGA Hardlight‚Ñ¢|Casual,Indie,Strategy
Shattered Steel|BioWare|Action,Simulation
Galaxy Force II‚Ñ¢|SEGA|Action
Eternal Champions‚Ñ¢|SEGA|Action
Marvel: Ultimate Alliance 2|Zo√´ Mode|Action,Adventure,RPG
The Club‚Ñ¢|Bizarre Creations|Action
MUD Motocross World Championship|Milestone S.r.l.|Racing,Sports
Return to Krondor|PyroTechnix|RPG
Hexodius|Brain Slap Studio|Action,Indie
The Elder Scrolls Online - Blackwood|Zenimax Online Studios|Massively Multiplayer,RPG
The DioField Chronicle|Square Enix,LANCARSE Ltd.|RPG,Strategy
Ray Gigant|BANDAI NAMCO Entertainment Inc.|Adventure,RPG
Steam 360 Video Player|Valve|nan
SolSeraph|ACE Team|Action,Strategy
Sword of the Stars II: Enhanced Edition|Kerberos Productions|Strategy
Crusaders: Thy Kingdom Come|NeocoreGames|Strategy
EA SPORTS‚Ñ¢ FIFA 23|EA Canada & EA Romania|Simulation,Sports
The Elder Scrolls Adventures: Redguard|Bethesda Softworks|Action,RPG
Deus Ex: The Fall|Square Enix|Action,Adventure,RPG
Dark Void‚Ñ¢ Zero|Other Ocean Interactive|Action,Adventure
Miaou Moon|Stephane Valverde,Leslie Valverde|Action,Casual,Indie
Titanfall¬≠‚Ñ¢|Respawn Entertainment|Action
Might & Magic: Heroes VI - Shades of Darkness|Virtuos|RPG,Strategy
Super Thunder Blade‚Ñ¢|SEGA|Action,Simulation
Break my body|Stephane Valverde|Action,Casual,Indie
Tom Clancy's Splinter Cell Double Agent¬Æ|Ubisoft Montreal|Action
Damnation|Blue Omega Entertainment|Action,Adventure
Citizens of Space|Eden Industries|RPG
Impire|Cyanide Montreal|Strategy
Gabriel Knight¬Æ 3: Blood of the Sacred, Blood of the Damned|Sierra On-Line|Adventure
BABYLON'S FALL|Square Enix,PlatinumGames Inc.|Action,RPG
Paper Dungeons|Stephane Valverde,Leslie Valverde|Adventure,Indie,RPG
Might & Magic Heroes Online|Blue Byte|Free to Play,Massively Multiplayer,RPG,Strategy
Ancient Space|CreativeForge Games|Strategy
Million Arthur VR: Character Command RPG|SQUARE ENIX,GREE, Inc.|RPG
BEAT ARENA|Konami Digital Entertainment|Casual
Champions of Anteria‚Ñ¢|Blue Byte|RPG,Strategy
Deus Ex: Breach‚Ñ¢|Eidos Montreal|Action,RPG
Premium Pool Arena|Iceflake Studios|Casual,Sports
Police Quest: SWAT|Yosemite Entertainment|Action,Simulation,Strategy
Wolfenstein: Cyberpilot|Arkane Studios,Machine Games|Action
Infinity Strash: DRAGON QUEST The Adventure of Dai|Square Enix,GameStudio Inc.,KAI GRAPHICS INC.|Action,RPG
Resident Evil Re:Verse|CAPCOM Co., Ltd.|Action
The Settlers Online|Blue Byte|Free to Play,Simulation,Strategy
Hospital Tycoon|Deep Red Limited|Simulation
FAST & FURIOUS CROSSROADS|Slightly Mad Studios|Action,Racing
Call of Duty¬Æ: Modern Warfare¬Æ III|Sledgehammer Games,Treyarch,Infinity Ward,Beenox,Raven Software,High Moon Studios,Demonware|Action
Impact Winter|Mojo Bones|Adventure,Indie,Simulation
FEMINAZI: 3000|Paradox Terminal|Casual,Indie,Racing
Fear Effect Sedna|Sushee|Action,Strategy
Puzzle Chronicles|Infinite Interactive|Casual,RPG
Umbrella Corps|CAPCOM|Action
Redfall|Arkane Austin|Action,Adventure
CONTRA: ROGUE CORPS|Konami Digital Entertainment|Action
Sleeping Dogs: Ghost Pig|United Front Games|Action,Adventure
THE QUIET MAN‚Ñ¢|Square Enix,Human Head Studios|Action
Hasfax|HorseGames|Indie
Monopoly Madness|Engine Software, Ubisoft|Action,Casual
Madden NFL 24|Tiburon|Simulation,Sports,Strategy
METAL GEAR SOLID: MASTER COLLECTION Vol.1 BONUS CONTENT|KONAMI|Action
EA SPORTS‚Ñ¢ PGA TOUR‚Ñ¢|Electronic Arts - Tiburon|RPG,Sports
Age of Booty‚Ñ¢|Certain Affinity‚Ñ¢|Casual,Strategy
Cave to Kingdom|Iubisoft System SRL|Casual,Free to Play,Massively Multiplayer,Strategy,Early Access
Prey: Typhon Hunter|Arkane Studios|Action
Attractio|GameCoder Studios|Action
Mass Effect 2 (2010) Edition|BioWare|RPG
Ghostbusters‚Ñ¢|FireForge Games|Action,Adventure
Prop Hunt|HorseGames|Casual,Indie,Massively Multiplayer,RPG,Sports
The Kings' Crusade|NeoCoreGames|Strategy
Aces of the Galaxy‚Ñ¢|Artech Studios|Action,Casual
Chunks|Facepunch Studios|Indie,Simulation,Early Access
Caf√© Rouge|Sonya Fung|Simulation
Alex Kidd‚Ñ¢ in the Enchanted Castle|SEGA|nan
Micro Machines World Series|Codemasters|Racing
LEFT ALIVE‚Ñ¢|Square Enix|Action
Tetris¬Æ Ultimate|Ubisoft - San Francisco|Casual
High School Otome|Sonya Fung|Free to Play
Oh My Godheads|Titutitech|Action
Command & Conquer 4: Tiberian Twilight|EA Los Angeles|Strategy
VARIOUS DAYLIFE|Square Enix,DOKIDOKI GROOVE WORKS|Adventure,RPG,Strategy
Defenders of Ardania|Most Wanted Entertainment|Strategy
Passengers: Awakening VR Experience|MPC VR|Adventure,Casual,Strategy
King Arthur: Fallen Champions|NeocoreGames|RPG,Strategy
Overlord: Fellowship of Evil|Codemasters|Action,Adventure
William and the Lands of Rage|HighRyseGaming|Adventure,Casual,Indie
Hearts of Iron III: Semper Fi|Paradox Development Studio|Strategy
FFXV WINDOWS EDITION 4K Resolution Pack|Square Enix|RPG
Covid Quest 2077|David S Womack Productions,Womack Games LLC|Casual,Indie
Pixel Tank|Down Right Epic Games|Casual,Simulation
Captain Curve's Intergalactic Space Adventure|CDP|Indie
The Outer Worlds: Spacer's Choice Edition|Obsidian Entertainment,Virtuos Games|Action,Adventure,RPG
Call of Duty¬Æ: Modern Warfare¬Æ II|Infinity Ward,Raven Software,Beenox,Treyarch,High Moon Studios,Sledgehammer Games,Activision Shanghai,Demonware,Toys for Bob|Action
Brain Spa|Ubisoft|Casual
FINAL FANTASY XV WINDOWS EDITION MOD ORGANIZER|Square Enix|Free to Play
Madden NFL 23|Tiburon|Simulation,Sports
Professional Lumberjack 2015|PlayWay S.A.|Simulation
Bhop PRO|HorseGames|Action,Adventure,Indie,Massively Multiplayer,Sports
Knights of Pen and Paper 3|Kyy Games|Adventure,RPG,Strategy
Nazi Elimination|ReverseGames|Violent,Action,Casual
Terrorist Elimination|ReverseGames|Violent,Action,Casual
Quantum Retribution|Paradox Bag|Indie
Biozone|G5 Entertainment|Action,Adventure,Casual
Morbid|Morbid Software|Action,Early Access
Aquarium Life|David S Womack Productions|Casual,Indie,RPG
Moon Whalers|Yusuke JuicyChicken Hasegawa|Action,Indie
Magical Girl Creator|Sonya Fung|Casual
Halo: Reach Mod Tools ‚Äì MCC|343 Industries,Splash Damage,Ruffian Games,Bungie,Saber Interactive|Action
Hades Nebula (C64/Spectrum)|Paranoid Software|Action
DRAGON QUEST TREASURES|Square Enix,TOSE CO., LTD.|Action,Casual,RPG
Street Legal 1: REVision|Invictus Games Ltd.,ImageCode|Racing,Simulation
The Charm of Love|Paradox White Cat|Indie
Dynamite Headdy|nan|nan
The Dark Pictures Anthology: House of Ashes - Friend's Pass|Supermassive Games|Action,Adventure
Rayman¬Æ Legends|nan|Action,Adventure
eFootball‚Ñ¢ 2022|Konami Digital Entertainment|Free to Play,Simulation,Sports
Prince of Persia: The Forgotten Sands‚Ñ¢ Digital Deluxe Edition|Ubisoft|Action,Adventure
The Elder Scrolls: Arena|Bethesda Softworks|Action,RPG
Phantasy Star II|nan|nan
Sword Art Online: Integral Factor|Asobimo, Inc.|Action,Adventure,Massively Multiplayer,RPG
STAR WARS‚Ñ¢: The Old Republic‚Ñ¢ - Public Test Server|BioWare|Massively Multiplayer
EA SPORTS FC‚Ñ¢ 24|EA Canada & EA Romania|Simulation,Sports
Warna|Epic Games,Netlex Studio|Action,Casual,Indie,RPG
Hexagon Survivors|Paradox Mind|Action,Casual,Free to Play,Indie,Strategy
The Elder Scrolls Online: Necrom|ZeniMax Online Studios|Action,Adventure,Massively Multiplayer,RPG
MOBILE SUIT GUNDAM BATTLE OPERATION 2|B.B.STUDIO CO.,LTD.,BEE TRIBE CO., LTD.|Action,Free to Play
Cat Girl Creator|Sonya Fung|Casual
Yu-Gi-Oh! Master Duel|Konami Digital Entertainment|Free to Play,Simulation,Strategy
Ninja Creator|Sonya Fung|Casual
VectorMan 2|nan|nan
Asian Maiden Creator|Sonya Fung|Casual
Cat Boy Creator|Sonya Fung|Casual
Resident Evil 4 Chainsaw Demo|CAPCOM Co., Ltd.|Action,Adventure
Bravery|Epic Games,Netlex Studio|Action,Adventure,Indie,Strategy
Trackmania|Nadeo|Racing
Spaceship Ace Pilot|Darian Segan|Action,Adventure,Casual,Indie,Simulation,Early Access
The Murder of Sonic the Hedgehog|SEGA|Casual,Free to Play,Indie,Simulation
Beyond Oasis|nan|nan
The Space Bar|Boffo Intergalactic Games,Jordan Freeman Group,Rocket Science Games,SegaSoft|Adventure
Aperture Desk Job|Valve|Action,Adventure,Casual,Free to Play
The Witch, Wife, & the Wish|Sonya Fung|Casual,Simulation
SQUARE ENIX AI Tech Preview: THE PORTOPIA SERIAL MURDER CASE|Square Enix|Adventure,Free to Play,Education,Software Training,Game Development
Mega Man X DiVE|CAPCOM TAIWAN|Action,Free to Play
Street Fighter‚Ñ¢ 6 - Open Beta|CAPCOM Co., Ltd.|Action,Adventure
Daikatana|nan|Action
MY HERO ULTRA RUMBLE|Byking Inc.|Action,Casual,Free to Play
EA SPORTS FC‚Ñ¢ 24|EA Canada & EA Romania|Simulation,Sports
Phantasy Star IV: The End of the Millennium|nan|nan
EA SPORTS FC‚Ñ¢ 24|EA Canada & EA Romania|Simulation,Sports
Call of Duty¬Æ: Warzone‚Ñ¢ 2.0|Infinity Ward,Raven Software,Beenox,Treyarch,High Moon Studios,Sledgehammer Games,Activision Shanghai,Demonware,Toys for Bob|Action,Free to Play
Halo 3 Mod Tools - MCC|343 Industries,Splash Damage,Ruffian Games,Bungie,Saber Interactive|Action
EA Play|nan|nan
Monster Hunter Rise: Sunbreak Demo|CAPCOM Co., Ltd.|Action
The Dark Pictures Anthology: The Devil In Me - Friend's Pass|Supermassive Games|Adventure
EA SPORTS‚Ñ¢ FIFA 23|EA Canada & EA Romania|Simulation,Sports
Wonder Boy in Monster World|nan|nan
Phantasy Star III: Generations of Doom|nan|nan
Majesty Gold HD|Cyberlore|Strategy,Simulation
Blood Omen 2: Legacy of Kain|nan|Action
Super Bomberman R Online|Konami Digital Entertainment|Action,Casual,Free to Play
Call of Duty¬Æ: Modern Warfare¬Æ II - Open Beta|Infinity Ward,Raven Software,Beenox,Treyarch,High Moon Studios,Sledgehammer Games,Activision Shanghai,Demonware,Toys for Bob|Action
Halo: CE Mod Tools - MCC|343 Industries,Splash Damage,Ruffian Games,Bungie,Saber Interactive|nan
Fantasy Girl Puzzle|Paradox White Cat|Casual,Indie
Monster Hunter Stories 2: Wings of Ruin Trial Version|CAPCOM Co., Ltd.|Adventure,RPG
GUNDAM EVOLUTION|BANDAI NAMCO Online Inc.|Action,Free to Play
The Elder Scrolls II: Daggerfall|Bethesda Softworks|Action,RPG
Flashback|nan|Action,Adventure,RPG
Lolita Creator|Sonya Fung|Casual
Samurai Creator|Sonya Fung|Casual
It Takes Two Friend's Pass|It Takes Two Friend's Pass|nan
Deathtrap Dungeon|nan|Action,Adventure
Streets of Rage 3|nan|Action
Beijing 2008‚Ñ¢ - The Official Video Game of the Olympic Games|Eurocom|Sports
The Revenge of Shinobi|nan|nan
Descend into Madness|Dream_Paradox|Indie
Survival Quiz CITY „Åä„Åæ„Å§„ÇäÁ∑®|Bandai Namco Studios Inc.|Action,Casual,Massively Multiplayer
Foggy Rainfall Escapade|Al Hasan Sony|Action,Adventure,Casual,Indie
Ghostwire: Tokyo - Prelude|Tango Gameworks|Adventure,Casual,Free to Play
Overwatch¬Æ 2|Blizzard Entertainment, Inc.|Action,Free to Play
Halo 2 Mod Tools - MCC|343 Industries,Saber Interactive,Bungie|nan
Anachronox|nan|RPG
Capcom Arcade 2nd Stadium|CAPCOM Co., Ltd.|Action,Free to Play
Golden Axe III|nan|nan
The Witcher 3: Wild Hunt - Game of the Year Edition|CD PROJEKT RED|RPG
Wolfenstein: Enemy Territory|Splash Damage|Action
Scott Pilgrim vs. The World‚Ñ¢: The Game ‚Äì Complete Edition|Engine Software,Ubisoft Montreal,Ubisoft Chengdu,Ubisoft Pune Production|Action,Adventure
Roller Champions‚Ñ¢|Ubisoft|Free to Play,Sports
Everlife|Mason Kimm|Action,Free to Play,Indie,Strategy,Early Access
Wolfteam: Reboot|Neosonyx Co., Ltd|Action,Free to Play
Teenage Mutant Ninja Turtles‚Ñ¢: Out of the Shadows|nan|Action
My Goddess of Love|Paradox White Cat|Casual,Indie
